suttaId,suttaScore,wordCount,similarSuttaCount,dissimilarSuttaCount,netSimilarCount
dn1,1.2894240663924528,7610,268,828,-560
dn2,1.3958374421527475,6854,320,652,-332
dn3,0.8197798624436148,4093,166,1054,-888
dn4,0.5627030213090745,2945,182,1576,-1394
dn5,0.6757135436783246,4208,192,1083,-891
dn6,0.469327352374016,1647,25,1877,-1852
dn7,0.22390324516994298,400,100,2700,-2600
dn8,0.8046165295858776,2583,115,1025,-910
dn9,1.0723178280160672,4163,197,1046,-849
dn10,1.0980427827990136,3271,245,724,-479
dn11,0.5799342388542295,1687,60,1640,-1580
dn12,0.7508322217350871,1660,162,1189,-1027
dn13,0.5587925646256098,2562,125,1529,-1404
dn14,0.8391319583300749,8373,184,884,-700
dn15,0.8572269418064549,2773,366,1292,-926
dn16,1.8677920973554585,14519,774,416,358
dn17,0.5800300237770672,4194,106,1558,-1452
dn18,1.2449365474683782,2737,380,739,-359
dn19,1.078506636596277,4656,234,838,-604
dn20,0.3256317541291187,914,15,2332,-2317
dn21,1.1055820272418915,3014,174,925,-751
dn22,1.2610736920765087,3795,636,897,-261
dn23,0.7177137972252057,6596,221,1285,-1064
dn24,0.5770855732053048,5214,113,1562,-1449
dn25,0.8481780790102755,3437,140,983,-843
dn26,0.8605765512710528,3290,160,1214,-1054
dn27,0.559841245971282,2811,37,1541,-1504
dn28,1.2278637618967858,2655,287,758,-471
dn29,1.1920687484078263,4095,195,647,-452
dn30,0.7186492872328865,3901,127,1186,-1059
dn31,0.39316155864397295,1588,95,2004,-1909
dn32,0.439994571019775,2527,49,1831,-1782
dn33,2.7875492098479393,8311,1323,295,1028
dn34,1.87638500822207,6045,1021,366,655
mn1,0.11594378857131549,1413,62,2936,-2874
mn2,0.9490410695414342,1165,224,986,-762
mn3,0.3095724412873535,890,124,2313,-2189
mn4,0.5874184768346113,1705,116,1542,-1426
mn5,0.7316116492514846,2155,324,1397,-1073
mn6,0.45368235227247755,690,70,1845,-1775
mn7,0.2724965820099845,953,74,2525,-2451
mn8,0.1950825802690348,1438,21,3085,-3064
mn9,0.6946444507906824,2119,458,1596,-1138
mn10,1.2669943821830065,3821,646,891,-245
mn11,0.5613748498519255,977,76,1474,-1398
mn12,1.1072317826325007,4150,390,778,-388
mn13,0.9562612736411458,1602,206,1149,-943
mn14,0.7864453284323503,1403,120,1209,-1089
mn15,0.23146880553361893,2169,137,2490,-2353
mn16,0.41681818484942124,872,70,2013,-1943
mn17,0.31473215280846123,1004,69,2312,-2243
mn18,0.6631668883045672,1407,166,1385,-1219
mn19,0.8451286094602217,1091,210,1271,-1061
mn20,0.19613374047791066,860,29,2754,-2725
mn21,0.5740523760038085,1900,55,1633,-1578
mn22,1.105524595852203,3043,322,800,-478
mn23,0.30545771344840933,579,43,2343,-2300
mn24,0.4838691481867219,1212,347,1810,-1463
mn25,0.24745911113526198,2196,11,2800,-2789
mn26,0.9431844631122788,3231,440,840,-400
mn27,1.1163295438794352,1736,416,655,-239
mn28,0.6829241690102128,1728,344,1436,-1092
mn29,0.5132622989350244,1640,104,1857,-1753
mn30,0.7779924136414929,1628,177,1272,-1095
mn31,0.5157254405556477,1373,114,1699,-1585
mn32,0.36364144769658324,1685,273,2135,-1862
mn33,0.6690797786783609,1147,123,1374,-1251
mn34,0.2239708977632704,511,37,2612,-2575
mn35,0.7138617623257737,2255,297,1217,-920
mn36,0.715313487535707,3907,123,1189,-1066
mn37,1.012657572426412,984,219,1156,-937
mn38,1.3067986536139609,3178,566,713,-147
mn39,0.8849200990787232,2043,186,1118,-932
mn40,0.4801830852956046,888,54,1832,-1778
mn41,0.8059893488066683,1251,468,1332,-864
mn42,0.6252040163957862,1012,403,1521,-1118
mn43,0.908109850438632,1390,394,1010,-616
mn44,0.8311648243035208,1152,307,1320,-1013
mn45,0.6432878702945066,882,133,1509,-1376
mn46,0.5088096121386387,1645,145,1849,-1704
mn47,0.5493713060119587,649,134,1788,-1654
mn48,0.8350941885151064,1126,194,1355,-1161
mn49,0.5370291805425031,1419,85,1744,-1659
mn50,0.6550710526386672,1460,102,1353,-1251
mn51,1.2637110692683917,2016,388,737,-349
mn52,0.5072952173130973,753,260,1774,-1514
mn53,0.7987874157645791,1110,214,1108,-894
mn54,1.126063507548536,1929,313,1048,-735
mn55,0.499723264528229,701,122,1882,-1760
mn56,0.569187790999881,3097,132,1629,-1497
mn57,0.6838011516533626,993,46,1445,-1399
mn58,0.5493916546920774,923,95,1773,-1678
mn59,0.48181476827977576,840,289,1715,-1426
mn60,1.095992743832297,2946,361,906,-545
mn61,0.1824325145732164,1390,71,2813,-2742
mn62,0.3466137548048698,1112,108,2217,-2109
mn63,0.38567287880222345,1513,295,2106,-1811
mn64,0.8696139195752517,980,350,1401,-1051
mn65,0.6546526620242687,2164,22,1391,-1369
mn66,0.5987331675118224,1997,84,1343,-1259
mn67,0.663565663065202,1221,125,1347,-1222
mn68,0.3298825361936597,1520,88,2247,-2159
mn69,0.14505376301412465,813,29,2978,-2949
mn70,0.8448449352178811,1916,204,1096,-892
mn71,0.39960746125686786,468,280,2099,-1819
mn72,0.4075571199811945,1414,239,1990,-1751
mn73,0.7126977518256972,1722,175,1118,-943
mn74,0.5987833747724158,827,176,1587,-1411
mn75,0.8556794196837414,2368,130,1033,-903
mn76,0.9492738594134353,2953,183,874,-691
mn77,0.9278827710687887,4305,191,927,-736
mn78,0.4093969000863451,1247,85,1955,-1870
mn79,0.9103190142429218,2023,152,1032,-880
mn80,0.5749933392593221,909,103,1504,-1401
mn81,0.3085940220412642,1771,151,2276,-2125
mn82,0.5573634269808503,3327,117,1496,-1379
mn83,0.4615127249186779,1835,171,1909,-1738
mn84,0.536097197941765,1474,133,1703,-1570
mn85,0.8805546590498148,4827,145,740,-595
mn86,0.6129503969731109,1374,117,1595,-1478
mn87,0.39132167939299745,1049,227,2017,-1790
mn88,0.3889640421517626,992,115,2048,-1933
mn89,0.6060645728308112,1379,175,1373,-1198
mn90,0.8484566256215853,1571,118,1083,-965
mn91,0.7841912082485303,2581,186,1127,-941
mn92,0.7915615115339003,1159,171,1299,-1128
mn93,0.5164531514994408,2073,147,1755,-1608
mn94,1.0932970194178937,2245,334,849,-515
mn95,0.7084653849221301,2621,188,1206,-1018
mn96,0.38753501556507697,1591,184,2065,-1881
mn97,0.592050347653883,2349,138,1762,-1624
mn98,0.35442626925992204,922,81,2186,-2105
mn99,0.6224266878321894,2314,136,1276,-1140
mn100,0.768488460386263,3094,133,1059,-926
mn101,1.1112588366129605,3445,348,843,-495
mn102,0.6552829062127064,1873,249,1513,-1264
mn103,0.41738934759181223,1010,36,2012,-1976
mn104,0.7578782026005815,1490,129,1359,-1230
mn105,0.5478524123702977,1776,25,1482,-1457
mn106,0.8290385172877057,890,137,1404,-1267
mn107,1.0384020577890896,1086,273,901,-628
mn108,0.8353892290803744,1566,339,1061,-722
mn109,1.0018047007190445,1017,430,1072,-642
mn110,0.3456359615452431,709,214,2213,-1999
mn111,0.6829071297586475,822,216,1604,-1388
mn112,1.0126678217597052,1345,426,1064,-638
mn113,0.5317811807988404,1457,209,1813,-1604
mn114,0.3689601941194054,2556,169,2132,-1963
mn115,0.6403187638425178,1181,195,1520,-1325
mn116,0.17027508654654522,452,59,2836,-2777
mn117,0.7477553389225511,1081,186,1341,-1155
mn118,0.561200782987803,1534,403,1735,-1332
mn119,0.8188383949712774,1926,228,1317,-1089
mn120,0.7020095809862514,1262,555,1621,-1066
mn121,0.31108738413552217,966,219,2274,-2055
mn122,0.9326648528369175,1533,328,1217,-889
mn123,0.41202554438335426,1203,83,2040,-1957
mn124,0.1650359334114171,527,37,3017,-2980
mn125,0.7896184730429079,1617,118,1282,-1164
mn126,0.17686172118656085,1471,20,2968,-2948
mn127,0.8118602564005206,1437,173,1191,-1018
mn128,0.4547432963599496,2147,59,1902,-1843
mn129,1.07905051938455,3087,314,875,-561
mn130,0.48770406259779353,1831,60,1822,-1762
mn131,0.2527311601734139,406,52,2602,-2550
mn132,0.23306199510151338,588,102,2584,-2482
mn133,0.554698948170973,1520,167,1595,-1428
mn134,0.24408421041670625,613,17,2577,-2560
mn135,0.599527584970283,1398,436,1736,-1300
mn136,0.8269432575807256,1917,551,1273,-722
mn137,0.8756127260370006,1357,278,1356,-1078
mn138,0.9274319502585948,1518,309,1120,-811
mn139,0.3911335463657739,1394,110,2052,-1942
mn140,1.0335319998682868,1934,377,887,-510
mn141,0.6855757937629603,833,331,1431,-1100
mn142,0.38368750020347786,839,178,2069,-1891
mn143,0.3875022326618849,1233,123,2015,-1892
mn144,0.41428881359732994,780,381,2001,-1620
mn145,0.253289579972793,651,40,2661,-2621
mn146,0.8192882183686523,2415,250,1274,-1024
mn147,0.34700661598481286,634,299,2242,-1943
mn148,0.517675166885545,1746,332,1811,-1479
mn149,0.6715809373760706,821,320,1503,-1183
mn150,0.5832015777203825,654,80,1758,-1678
mn151,0.5613477626014385,1037,133,1518,-1385
mn152,0.287854287309397,973,118,2411,-2293
sn1.1,0.19179876997788003,96,136,2500,-2364
sn1.2,0.21912797029619568,59,47,2473,-2426
sn1.3,4.376269049366499e-05,35,47,3345,-3298
sn1.4,4.376269051586945e-05,37,39,3499,-3460
sn1.5,0.06313576302832136,33,82,3261,-3179
sn1.6,0.061799775709991955,29,20,3279,-3259
sn1.7,0.14375550937477666,32,64,2665,-2601
sn1.8,0.14518601020905297,32,66,2658,-2592
sn1.9,0.053509150612707224,38,33,3199,-3166
sn1.10,0.11853858852253207,47,16,3005,-2989
sn1.11,0.3047034184039177,76,68,2282,-2214
sn1.12,0.04555503559644514,41,30,3171,-3141
sn1.13,4.376269051586945e-05,33,72,3259,-3187
sn1.14,4.376269049366499e-05,22,19,3980,-3961
sn1.15,4.376269049366499e-05,21,4,4188,-4184
sn1.16,4.376269049366499e-05,19,3,4233,-4230
sn1.17,4.376269051586945e-05,32,9,4139,-4130
sn1.18,4.376269051586945e-05,22,22,3435,-3413
sn1.19,4.376269049366499e-05,62,35,4024,-3989
sn1.20,0.45904627495580996,656,170,1938,-1768
sn1.21,0.11027110134524953,27,109,2971,-2862
sn1.22,4.376269049366499e-05,24,9,3749,-3740
sn1.23,4.376269049366499e-05,48,23,3172,-3149
sn1.24,4.376269051586945e-05,31,43,3437,-3394
sn1.25,4.376269051586945e-05,80,20,3424,-3404
sn1.26,4.376269051586945e-05,33,18,3377,-3359
sn1.27,4.376269049366499e-05,31,11,4175,-4164
sn1.28,4.376269049366499e-05,31,12,3921,-3909
sn1.29,4.376269049366499e-05,20,12,4132,-4120
sn1.30,4.376269051586945e-05,38,16,3491,-3475
sn1.31,0.13561907447681154,169,67,2939,-2872
sn1.32,0.32897894613999057,219,85,2382,-2297
sn1.33,0.22973256884786242,263,53,2863,-2810
sn1.34,0.45425830751502083,142,44,2002,-1958
sn1.35,0.28929885300048586,201,63,2319,-2256
sn1.36,0.2067859454729204,91,73,2491,-2418
sn1.37,0.3680454577973835,176,98,2138,-2040
sn1.38,0.17505788696008384,329,89,2774,-2685
sn1.39,0.37699768660910404,88,42,2126,-2084
sn1.40,0.2976824166053049,89,49,2321,-2272
sn1.41,0.1979640677479244,93,76,2589,-2513
sn1.42,4.376269051586945e-05,44,1,3760,-3759
sn1.43,4.376269053807391e-05,33,17,3114,-3097
sn1.44,4.376269049366499e-05,9,0,4365,-4365
sn1.45,4.376269049366499e-05,13,0,4350,-4350
sn1.46,4.376269051586945e-05,39,13,3047,-3034
sn1.47,4.376269049366499e-05,34,7,3841,-3834
sn1.48,4.376269049366499e-05,41,28,3307,-3279
sn1.49,4.376269051586945e-05,120,11,3451,-3440
sn1.50,0.09348940854099208,142,14,3167,-3153
sn1.51,4.376269049366499e-05,25,35,3894,-3859
sn1.52,4.376269049366499e-05,21,31,3998,-3967
sn1.53,4.376269049366499e-05,29,11,4181,-4170
sn1.54,4.376269049366499e-05,24,30,3903,-3873
sn1.55,4.376269049366499e-05,19,46,4091,-4045
sn1.56,4.376269049366499e-05,20,52,3990,-3938
sn1.57,4.376269051586945e-05,20,53,4039,-3986
sn1.58,4.376269049366499e-05,25,53,3520,-3467
sn1.59,4.376269049366499e-05,22,27,4121,-4094
sn1.60,4.376269049366499e-05,33,25,3959,-3934
sn1.61,4.376269049366499e-05,21,50,4103,-4053
sn1.62,4.376269049366499e-05,17,23,4219,-4196
sn1.63,4.376269049366499e-05,17,22,4251,-4229
sn1.64,4.376269049366499e-05,19,56,3931,-3875
sn1.65,4.376269049366499e-05,19,59,4087,-4028
sn1.66,4.376269049366499e-05,17,24,4118,-4094
sn1.67,4.376269049366499e-05,21,41,4180,-4139
sn1.68,4.376269049366499e-05,21,41,4180,-4139
sn1.69,4.376269049366499e-05,20,41,4094,-4053
sn1.70,4.376269049366499e-05,33,49,3976,-3927
sn1.71,4.376269051586945e-05,39,41,3281,-3240
sn1.72,4.376269049366499e-05,19,25,3971,-3946
sn1.73,4.376269049366499e-05,27,18,4139,-4121
sn1.74,4.376269049366499e-05,31,21,4174,-4153
sn1.75,4.376269049366499e-05,36,5,3317,-3312
sn1.76,0.08328400522445989,72,43,2749,-2706
sn1.77,4.376269049366499e-05,38,30,3963,-3933
sn1.78,4.376269049366499e-05,26,16,4078,-4062
sn1.79,4.376269049366499e-05,34,40,3901,-3861
sn1.80,4.376269051586945e-05,43,23,3847,-3824
sn1.81,4.376269053807391e-05,58,17,3596,-3579
sn2.1,0.20515109207990267,74,110,2540,-2430
sn2.2,4.376269051586945e-05,23,81,3025,-2944
sn2.3,4.376269049366499e-05,57,77,2926,-2849
sn2.4,0.11929733534425946,41,33,2690,-2657
sn2.5,0.1289262032196259,73,52,2733,-2681
sn2.6,0.13592556724375537,76,40,3005,-2965
sn2.7,0.2557608827135516,32,40,2394,-2354
sn2.8,0.16678686884072924,196,49,2657,-2608
sn2.9,0.16077724430634266,98,27,2732,-2705
sn2.10,0.23242375971601614,125,18,2547,-2529
sn2.11,0.14677398011062603,49,70,2639,-2569
sn2.12,4.376269051586945e-05,32,27,3426,-3399
sn2.13,0.1267787264723319,51,100,2627,-2527
sn2.14,4.376269051586945e-05,49,8,3703,-3695
sn2.15,4.376269053807391e-05,32,16,3061,-3045
sn2.16,4.376269049366499e-05,26,99,3500,-3401
sn2.17,4.376269053807391e-05,37,48,3054,-3006
sn2.18,0.18292822637659967,114,73,2493,-2420
sn2.19,4.376269051586945e-05,35,33,3652,-3619
sn2.20,0.28543254029818055,196,108,2373,-2265
sn2.21,0.07867933134340088,108,22,3401,-3379
sn2.22,0.06840425881760037,70,34,3088,-3054
sn2.23,0.20947210102904013,401,29,2826,-2797
sn2.24,0.06903695543014621,145,17,3014,-2997
sn2.25,4.376269049366499e-05,84,32,2841,-2809
sn2.26,0.29386033905749454,236,42,2368,-2326
sn2.27,4.376269049366499e-05,36,33,3893,-3860
sn2.28,4.376269049366499e-05,26,22,3663,-3641
sn2.29,0.2225409356797492,494,167,2709,-2542
sn2.30,0.39930526831830626,259,103,2006,-1903
sn3.1,0.3582174475371014,344,49,2181,-2132
sn3.2,0.25277341657952146,105,110,2465,-2355
sn3.3,0.17559151497883452,92,55,2842,-2787
sn3.4,0.1838490254930436,272,161,2672,-2511
sn3.5,0.12751240433119815,224,111,2896,-2785
sn3.6,0.11427726212933642,134,86,3139,-3053
sn3.7,0.11605450094591685,86,54,2980,-2926
sn3.8,0.17759967867145843,147,72,2689,-2617
sn3.9,0.31610927448901815,182,161,2290,-2129
sn3.10,0.16445963798912278,101,28,2759,-2731
sn3.11,0.2927933980639841,396,78,2432,-2354
sn3.12,0.4345608567009718,420,61,1968,-1907
sn3.13,0.23234278985768686,154,49,2599,-2550
sn3.14,0.11522478973429173,234,101,3083,-2982
sn3.15,0.05284277225954259,354,114,3347,-3233
sn3.16,0.16519112129220748,73,32,2570,-2538
sn3.17,0.3313192646182461,120,110,2262,-2152
sn3.18,0.41175509046817993,371,180,2000,-1820
sn3.19,0.2431944311772627,418,33,2622,-2589
sn3.20,0.3736660091037125,304,88,2116,-2028
sn3.21,0.33442823423621704,588,270,2273,-2003
sn3.22,0.18292360726601675,167,42,2893,-2851
sn3.23,0.20514404461655644,87,101,2827,-2726
sn3.24,0.37061720297193457,350,46,2110,-2064
sn3.25,0.3044736253585034,390,41,2409,-2368
sn4.1,0.3014464786233795,105,89,2355,-2266
sn4.2,0.30089773348553894,98,99,2296,-2197
sn4.3,0.3022591795391216,91,86,2298,-2212
sn4.4,0.1791198383112258,87,96,2619,-2523
sn4.5,0.3834967057411376,117,135,2121,-1986
sn4.6,0.3134274632740519,145,57,2299,-2242
sn4.7,0.23862346054264183,75,41,2651,-2610
sn4.8,0.06958052224794731,67,93,2926,-2833
sn4.9,0.14384017284110318,79,102,2670,-2568
sn4.10,0.1661064484317576,89,68,2715,-2647
sn4.11,0.23529656209426708,70,107,2494,-2387
sn4.12,0.2257501201505141,80,130,2408,-2278
sn4.13,0.1948903559249926,138,40,2665,-2625
sn4.14,0.21806869561526998,71,93,2566,-2473
sn4.15,0.14037354983462702,59,159,2632,-2473
sn4.16,0.4453270203722548,148,137,1963,-1826
sn4.17,0.2758513655480188,156,106,2341,-2235
sn4.18,0.25698232654860487,125,58,2416,-2358
sn4.19,0.26520835761847383,267,152,2493,-2341
sn4.20,0.24484640400341817,148,38,2575,-2537
sn4.21,0.29637317414759057,271,103,2333,-2230
sn4.22,0.25301122216330185,257,102,2510,-2408
sn4.23,0.20274364848757997,394,57,2792,-2735
sn4.24,0.5126978545290317,240,45,1695,-1650
sn4.25,0.20249377961523152,594,33,2562,-2529
sn5.1,0.21823241801735005,138,82,2485,-2403
sn5.2,0.22294840769652158,133,87,2550,-2463
sn5.3,0.1602128949085957,131,76,2663,-2587
sn5.4,0.21146240726019894,128,64,2617,-2553
sn5.5,0.16117242949238442,136,64,2749,-2685
sn5.6,0.33749032213976626,92,62,2224,-2162
sn5.7,0.26190983505751664,98,79,2445,-2366
sn5.8,0.29201159701433,96,48,2348,-2300
sn5.9,0.14493979764149678,126,58,3022,-2964
sn5.10,0.3009165552025683,163,54,2324,-2270
sn6.1,0.4804103215833244,377,51,1764,-1713
sn6.2,0.27538364837298435,348,61,2465,-2404
sn6.3,0.35094180277648324,236,53,2198,-2145
sn6.4,0.3513284399704997,301,27,2195,-2168
sn6.5,0.4109655906182841,439,110,2031,-1921
sn6.6,0.22450695441735835,272,48,2595,-2547
sn6.7,4.376269049366499e-05,47,23,3173,-3150
sn6.8,4.376269049366499e-05,47,19,3188,-3169
sn6.9,0.36556924209671937,112,71,2148,-2077
sn6.10,0.3673233002544407,527,62,2148,-2086
sn6.11,0.28436840211496506,63,97,2322,-2225
sn6.12,0.06779454331735657,57,85,2741,-2656
sn6.13,0.296747374828743,111,47,2315,-2268
sn6.14,0.29566145414829936,476,109,2411,-2302
sn6.15,0.18689160493148282,220,89,2861,-2772
sn7.1,0.5154855446330542,259,166,1790,-1624
sn7.2,0.46439635076875874,276,135,1881,-1746
sn7.3,0.28853926357415016,109,57,2380,-2323
sn7.4,0.17992266738604545,74,73,2590,-2517
sn7.5,0.24893081373036363,72,95,2365,-2270
sn7.6,0.2085822641695101,89,92,2436,-2344
sn7.7,0.2614738243125636,82,81,2411,-2330
sn7.8,0.2904082097608285,134,79,2419,-2340
sn7.9,0.3023621311274427,365,76,2393,-2317
sn7.10,0.2517333712208636,317,105,2553,-2448
sn7.11,0.2640849021121605,241,78,2457,-2379
sn7.12,0.028434946093569557,118,18,3393,-3375
sn7.13,0.2346072107125119,194,114,2470,-2356
sn7.14,0.23948072456814185,250,73,2485,-2412
sn7.15,0.274682569178597,269,114,2441,-2327
sn7.16,0.3178510094979936,88,119,2261,-2142
sn7.17,0.09060920497137026,105,72,3078,-3006
sn7.18,0.2765747266961993,177,73,2431,-2358
sn7.19,0.09973661669160361,103,123,2762,-2639
sn7.20,0.26196622050822516,83,114,2419,-2305
sn7.21,0.29541111499724604,215,152,2318,-2166
sn7.22,0.4050754303022597,157,119,2041,-1922
sn8.1,0.29927175304582665,155,20,2395,-2375
sn8.2,0.18090800381722616,169,14,2658,-2644
sn8.3,0.025263878079195834,105,17,3097,-3080
sn8.4,0.12628773833121,85,91,2697,-2606
sn8.5,0.4203705231533572,168,80,2006,-1926
sn8.6,0.11587456629935655,146,163,2839,-2676
sn8.7,0.39567688378030486,278,76,2004,-1928
sn8.8,0.5903021055059465,229,85,1707,-1622
sn8.9,0.05860301332656359,132,39,2842,-2803
sn8.10,0.2643311797594583,119,54,2461,-2407
sn8.11,0.14878004008516132,115,47,2623,-2576
sn8.12,0.3157753409713582,84,32,2274,-2242
sn9.1,0.24034903259575469,96,21,2499,-2478
sn9.2,0.24781117594623314,98,15,2508,-2493
sn9.3,0.15274160926510572,74,32,2798,-2766
sn9.4,4.376269051586945e-05,64,118,3303,-3185
sn9.5,0.17986143552812806,58,95,2616,-2521
sn9.6,0.15793175725888897,82,34,2595,-2561
sn9.7,0.1323698915164373,68,23,2840,-2817
sn9.8,0.23315638690444285,82,33,2476,-2443
sn9.9,0.19678201322606004,84,31,2580,-2549
sn9.10,0.26270609993941374,76,23,2426,-2403
sn9.11,0.2669802200455207,71,43,2372,-2329
sn9.12,4.376269049366499e-05,45,41,3177,-3136
sn9.13,0.1923922377282894,96,75,2547,-2472
sn9.14,0.30452381621586255,137,17,2403,-2386
sn10.1,0.13375369678250149,68,8,2799,-2791
sn10.2,0.1311324274863912,46,23,2628,-2605
sn10.3,0.230217503649377,183,34,2659,-2625
sn10.4,4.376269051586945e-05,53,14,3362,-3348
sn10.5,0.29818009260476064,154,35,2362,-2327
sn10.6,4.376269049366499e-05,51,48,3222,-3174
sn10.7,0.34398038354395144,138,47,2208,-2161
sn10.8,0.16673841714198723,314,82,2887,-2805
sn10.9,0.13667285344958202,56,36,2781,-2745
sn10.10,4.376269051586945e-05,46,50,3246,-3196
sn10.11,0.09036146911252096,50,46,3188,-3142
sn10.12,0.413668768013431,296,21,2034,-2013
sn11.1,0.11657117976977549,224,30,3008,-2978
sn11.2,0.09171009446560241,179,29,2922,-2893
sn11.3,0.18756060801499164,373,40,2726,-2686
sn11.4,0.3969584900108236,269,127,2029,-1902
sn11.5,0.21900058211181683,325,41,2667,-2626
sn11.6,4.376269051586945e-05,85,20,3742,-3722
sn11.7,0.13404373092005262,79,35,3171,-3136
sn11.8,0.017554128787833356,81,23,3251,-3228
sn11.9,4.376269051586945e-05,112,21,3678,-3657
sn11.10,0.11791321333327609,180,17,3271,-3254
sn11.11,0.09075634787920617,87,45,3260,-3215
sn11.12,0.21447154763800658,165,54,2627,-2573
sn11.13,0.28703673087568937,221,41,2428,-2387
sn11.14,0.2033948063317137,223,288,2640,-2352
sn11.15,0.05529466800469063,46,36,2780,-2744
sn11.16,0.06849997548252773,55,41,2772,-2731
sn11.17,0.027084609679528526,69,36,3290,-3254
sn11.18,0.21878547806608584,136,23,2749,-2726
sn11.19,0.27975467095182616,129,26,2416,-2390
sn11.20,0.15372272658040753,156,17,2900,-2883
sn11.21,4.376269051586945e-05,52,53,3080,-3027
sn11.22,0.19094708203191146,223,74,2637,-2563
sn11.23,4.376269051586945e-05,90,18,3700,-3682
sn11.24,0.3222782265677848,136,50,2263,-2213
sn11.25,0.2973145864054505,74,68,2327,-2259
sn12.1,0.47567241434331997,119,249,1971,-1722
sn12.2,0.5627071615871282,319,540,1901,-1361
sn12.3,0.31360346980005005,66,297,2241,-1944
sn12.4,0.1741628075615509,804,68,2946,-2878
sn12.5,4.376269051586945e-05,8,57,3738,-3681
sn12.6,4.376269049366499e-05,8,55,3740,-3685
sn12.7,4.376269049366499e-05,8,57,3736,-3679
sn12.8,4.376269049366499e-05,8,56,3738,-3682
sn12.9,4.376269049366499e-05,8,67,3709,-3642
sn12.10,0.3937008376104556,264,192,2085,-1893
sn12.11,0.3446641967430386,171,163,2200,-2037
sn12.12,0.36201135482765157,322,51,2158,-2107
sn12.13,0.1906639662048626,150,139,2535,-2396
sn12.14,0.2252992847217694,244,147,2560,-2413
sn12.15,0.5873441189178541,141,211,1708,-1497
sn12.16,0.34448864127902823,136,148,2207,-2059
sn12.17,0.6154116023754375,535,221,1524,-1303
sn12.18,0.33353443645136593,320,144,2278,-2134
sn12.19,0.4747978322737989,216,52,1889,-1837
sn12.20,0.540282338212128,349,102,1653,-1551
sn12.21,0.2982887065112738,100,247,2291,-2044
sn12.22,0.5933344809861962,245,205,1753,-1548
sn12.23,0.15888018226106748,418,46,2844,-2798
sn12.24,0.40188916084771265,841,193,2049,-1856
sn12.25,0.37215144957427615,563,125,2100,-1975
sn12.26,0.36045261117712,186,122,2177,-2055
sn12.27,0.7897026785349981,203,409,1558,-1149
sn12.28,0.5087359241708667,261,299,1848,-1549
sn12.29,0.1618275397464286,161,95,2769,-2674
sn12.30,0.232491447548,141,145,2459,-2314
sn12.31,0.2920374546118376,397,213,2326,-2113
sn12.32,0.37295446000191745,1071,158,2102,-1944
sn12.33,0.5788790646457764,481,224,1605,-1381
sn12.34,0.06185303582293411,140,53,3394,-3341
sn12.35,0.37905452985675936,516,156,2119,-1963
sn12.36,0.3433405814379453,289,173,2212,-2039
sn12.37,0.25722161122969656,68,282,2312,-2030
sn12.38,0.07010578831132541,120,131,2781,-2650
sn12.39,0.12403345968583501,126,101,2822,-2721
sn12.40,0.11123583486327693,149,140,2706,-2566
sn12.41,0.5955564610578223,373,210,1670,-1460
sn12.42,0.311274753856261,153,164,2285,-2121
sn12.43,0.17480619370264794,194,183,2596,-2413
sn12.44,0.21120671881365016,187,233,2544,-2311
sn12.45,0.19430710307559718,191,167,2526,-2359
sn12.46,0.48520836050205407,116,235,2021,-1786
sn12.47,0.4454405313217835,94,325,2078,-1753
sn12.48,0.2959994053168602,110,240,2287,-2047
sn12.49,0.176515401931443,276,130,2708,-2578
sn12.50,0.388755063738766,302,145,2092,-1947
sn12.51,0.8024817616825608,655,303,1232,-929
sn12.52,0.16513749842583803,168,97,2761,-2664
sn12.53,0.18739135987797528,142,143,2573,-2430
sn12.54,0.11530371008134921,95,70,2736,-2666
sn12.55,0.08970970082240459,167,70,2954,-2884
sn12.56,0.10185368893254054,100,57,2763,-2706
sn12.57,0.0586718964816102,127,94,2817,-2723
sn12.58,0.034704625400716616,108,73,3044,-2971
sn12.59,0.027157459028015474,94,95,3051,-2956
sn12.60,0.4607591988967652,260,174,1963,-1789
sn12.61,0.46057756381852055,272,135,1852,-1717
sn12.62,0.3604632480070036,338,221,2170,-1949
sn12.63,0.7160913278927206,508,64,1228,-1164
sn12.64,0.08927027120593234,563,134,2792,-2658
sn12.65,0.4310998515616893,553,146,1949,-1803
sn12.66,0.3321692148071653,1001,118,2262,-2144
sn12.67,0.2743685487240688,468,256,2387,-2131
sn12.68,0.10372879355224907,573,81,2853,-2772
sn12.69,0.04298160968099207,144,12,3618,-3606
sn12.70,0.9764885369069942,1542,318,1139,-821
sn12.71,0.19365713737233836,108,119,2582,-2463
sn12.72,0.10868531061098974,73,76,3024,-2948
sn12.73,0.10868531061098974,73,76,3024,-2948
sn12.74,0.10868531061098974,73,76,3024,-2948
sn12.75,0.10868531061098974,73,76,3024,-2948
sn12.76,0.10868531061098974,73,76,3024,-2948
sn12.77,0.10868531061098974,73,76,3024,-2948
sn12.78,0.10868531061098974,73,76,3024,-2948
sn12.79,0.10868531061098974,73,76,3024,-2948
sn12.80,0.10868531061098974,73,76,3024,-2948
sn12.81,0.10868531061098974,73,76,3024,-2948
sn12.82,4.376269049366499e-05,44,141,3467,-3326
sn12.83,4.376269051586945e-05,102,167,3338,-3171
sn12.84,4.376269051586945e-05,102,167,3338,-3171
sn12.85,4.376269051586945e-05,102,167,3338,-3171
sn12.86,4.376269051586945e-05,102,167,3338,-3171
sn12.87,4.376269051586945e-05,102,167,3338,-3171
sn12.88,4.376269051586945e-05,102,167,3338,-3171
sn12.89,4.376269051586945e-05,102,167,3338,-3171
sn12.90,4.376269051586945e-05,102,167,3338,-3171
sn12.91,4.376269051586945e-05,102,167,3338,-3171
sn12.92,4.376269051586945e-05,102,167,3338,-3171
sn12.93,4.376269049366499e-05,148,41,3361,-3320
sn13.1,0.2415824988858839,110,63,2605,-2542
sn13.2,0.19427931954256739,105,63,2791,-2728
sn13.3,0.21066817305532837,78,97,2609,-2512
sn13.4,0.17683291460772743,87,87,2763,-2676
sn13.5,0.10475441269097718,61,74,3168,-3094
sn13.6,0.09346620446928355,69,66,3375,-3309
sn13.7,0.13425215110003386,72,48,2975,-2927
sn13.8,0.11656557433512571,80,47,3076,-3029
sn13.9,0.15355437731205956,64,67,2994,-2927
sn13.10,0.17046403505867058,107,86,2988,-2902
sn13.11,0.2678245873871665,99,76,2559,-2483
sn14.1,0.10794564367502257,44,161,2858,-2697
sn14.2,4.376269053807391e-05,52,95,3592,-3497
sn14.3,0.048808857532578465,67,130,3639,-3509
sn14.4,0.08103595516366635,64,181,3409,-3228
sn14.5,0.06289239262151636,116,189,3590,-3401
sn14.6,4.376269051586945e-05,23,141,3127,-2986
sn14.7,0.029629793606722465,120,122,3273,-3151
sn14.8,0.021471988590504587,177,110,3295,-3185
sn14.9,0.09073398241195019,146,183,3194,-3011
sn14.10,0.11799142968456078,258,171,2987,-2816
sn14.11,0.12158061580882507,158,128,2821,-2693
sn14.12,0.3984604900974853,361,170,2059,-1889
sn14.13,0.11052334305376998,149,77,3055,-2978
sn14.14,4.376269049366499e-05,69,17,3954,-3937
sn14.15,4.376269049366499e-05,290,27,3306,-3279
sn14.16,0.020673512856217435,235,42,3887,-3845
sn14.17,4.376269051586945e-05,249,25,3938,-3913
sn14.18,4.376269051586945e-05,253,21,3950,-3929
sn14.19,4.376269051586945e-05,139,22,4146,-4124
sn14.20,4.376269049366499e-05,107,21,4096,-4075
sn14.21,4.376269049366499e-05,74,21,4013,-3992
sn14.22,0.08968836681080283,66,21,3091,-3070
sn14.23,4.376269051586945e-05,56,22,4011,-3989
sn14.24,4.376269051586945e-05,56,22,4005,-3983
sn14.25,4.376269049366499e-05,66,60,3868,-3808
sn14.26,4.376269049366499e-05,80,63,3713,-3650
sn14.27,4.376269049366499e-05,89,43,3704,-3661
sn14.28,4.376269051586945e-05,54,34,3448,-3414
sn14.29,0.07861096658976496,86,31,3156,-3125
sn14.30,4.376269049366499e-05,23,119,3413,-3294
sn14.31,0.4007475633895696,173,142,2090,-1948
sn14.32,0.11777806025532467,166,73,2782,-2709
sn14.33,0.01769288629720478,205,132,3404,-3272
sn14.34,4.376269051586945e-05,135,58,3757,-3699
sn14.35,4.376269051586945e-05,74,191,3487,-3296
sn14.36,4.376269051586945e-05,67,98,3759,-3661
sn14.37,0.1093317570491692,101,206,2763,-2557
sn14.38,4.376269053807391e-05,43,229,2808,-2579
sn14.39,0.1094048994674024,149,78,2944,-2866
sn15.1,0.4427215279091845,109,73,1951,-1878
sn15.2,0.276197868214223,79,48,2443,-2395
sn15.3,0.20452083559359124,190,28,2685,-2657
sn15.4,0.2237677606814703,101,57,2771,-2714
sn15.5,0.23688713696412567,143,41,2476,-2435
sn15.6,0.1575815033825867,117,31,2766,-2735
sn15.7,0.15926877447249854,125,38,2774,-2736
sn15.8,0.3340143457222666,191,161,2263,-2102
sn15.9,0.19060707960800727,59,31,2702,-2671
sn15.10,0.44988647402930404,111,63,1944,-1881
sn15.11,0.22798261154426402,50,58,2458,-2400
sn15.12,4.376269051586945e-05,36,27,3392,-3365
sn15.13,0.24257116178858507,281,33,2641,-2608
sn15.14,4.376269051586945e-05,29,26,3120,-3094
sn15.15,4.376269051586945e-05,20,46,3366,-3320
sn15.16,4.376269051586945e-05,17,35,3365,-3330
sn15.17,4.376269051586945e-05,17,46,3247,-3201
sn15.18,4.376269051586945e-05,17,35,3373,-3338
sn15.19,0.27328890249276316,61,58,2428,-2370
sn15.20,0.3420610061895202,412,66,2211,-2145
sn16.1,0.08856571392341639,205,39,3367,-3328
sn16.2,0.09703219997130308,302,128,3037,-2909
sn16.3,0.31956672246480355,351,107,2283,-2176
sn16.4,0.06066031446110287,356,38,3115,-3077
sn16.5,0.12904360009888816,314,71,3209,-3138
sn16.6,0.28993620839135037,330,67,2363,-2296
sn16.7,0.11994922263645069,529,102,2891,-2789
sn16.8,0.2196740554282206,418,59,2629,-2570
sn16.9,0.43939382315763,670,204,1914,-1710
sn16.10,0.49937818617908913,403,397,1851,-1454
sn16.11,0.5394587509212068,658,311,1601,-1290
sn16.12,0.33837809241263894,198,601,2216,-1615
sn16.13,0.5391844701093662,291,41,1658,-1617
sn17.1,0.2550478090445729,52,136,2468,-2332
sn17.2,0.13001075231184878,97,66,2869,-2803
sn17.3,0.17043467797701606,174,55,2934,-2879
sn17.4,0.09477045625112535,72,139,3005,-2866
sn17.5,0.17755692358434327,118,83,2793,-2710
sn17.6,4.376269049366499e-05,33,68,3395,-3327
sn17.7,4.376269051586945e-05,35,64,3451,-3387
sn17.8,0.1729020292524419,97,72,2776,-2704
sn17.9,0.1956381805497509,116,73,2790,-2717
sn17.10,0.2863570685451622,110,366,2340,-1974
sn17.11,0.23308331920854908,46,62,2548,-2486
sn17.12,0.23288783913548716,45,61,2544,-2483
sn17.13,0.32242117127354586,71,70,2270,-2200
sn17.14,0.32242117127354586,71,70,2270,-2200
sn17.15,0.32242117127354586,71,70,2270,-2200
sn17.16,0.32242117127354586,71,70,2270,-2200
sn17.17,0.32242117127354586,71,70,2270,-2200
sn17.18,0.32242117127354586,71,70,2270,-2200
sn17.19,0.32242117127354586,71,70,2270,-2200
sn17.20,0.32242117127354586,71,70,2270,-2200
sn17.21,4.376269049366499e-05,34,94,3071,-2977
sn17.22,4.376269049366499e-05,34,76,3091,-3015
sn17.23,4.376269053807391e-05,97,119,2984,-2865
sn17.24,0.05018849241522627,106,90,3039,-2949
sn17.25,0.09674877447782837,88,224,2797,-2573
sn17.26,4.376269051586945e-05,30,249,2798,-2549
sn17.27,0.1522177824912596,32,154,2742,-2588
sn17.28,4.376269051586945e-05,42,56,3704,-3648
sn17.29,4.376269051586945e-05,101,56,3871,-3815
sn17.30,0.273505050177536,91,134,2411,-2277
sn17.31,4.376269051586945e-05,21,66,3520,-3454
sn17.32,4.376269049366499e-05,21,59,3545,-3486
sn17.33,4.376269051586945e-05,22,70,3365,-3295
sn17.34,4.376269051586945e-05,22,57,3391,-3334
sn17.35,0.11504669669120116,131,97,3008,-2911
sn17.36,0.2113058963942649,132,60,2763,-2703
sn17.37,0.09797397242268246,65,66,3059,-2993
sn17.38,0.2810166720188745,98,70,2371,-2301
sn17.39,0.2810166720188745,98,70,2371,-2301
sn17.40,0.2810166720188745,98,70,2371,-2301
sn17.41,0.2810166720188745,98,70,2371,-2301
sn17.42,0.2810166720188745,98,70,2371,-2301
sn17.43,0.2810166720188745,98,70,2371,-2301
sn18.1,0.3889414286416537,195,275,2150,-1875
sn18.2,4.376269049366499e-05,60,142,3407,-3265
sn18.3,4.376269051586945e-05,62,157,3582,-3425
sn18.4,4.376269051586945e-05,62,119,3799,-3680
sn18.5,4.376269051586945e-05,64,202,3298,-3096
sn18.6,4.376269051586945e-05,60,114,3455,-3341
sn18.7,4.376269051586945e-05,60,113,3472,-3359
sn18.8,4.376269051586945e-05,60,119,3386,-3267
sn18.9,4.376269051586945e-05,60,128,3517,-3389
sn18.10,4.376269051586945e-05,80,219,3011,-2792
sn18.11,0.31378474328391803,154,258,2250,-1992
sn18.12,0.06228718929544019,151,291,3020,-2729
sn18.13,0.06228718929544019,151,291,3020,-2729
sn18.14,0.06228718929544019,151,291,3020,-2729
sn18.15,0.06228718929544019,151,291,3020,-2729
sn18.16,0.06228718929544019,151,291,3020,-2729
sn18.17,0.06228718929544019,151,291,3020,-2729
sn18.18,0.06228718929544019,151,291,3020,-2729
sn18.19,0.06228718929544019,151,291,3020,-2729
sn18.20,0.06228718929544019,151,291,3020,-2729
sn18.21,0.5912724673988068,131,227,1774,-1547
sn18.22,0.7494116671707074,162,225,1443,-1218
sn19.1,0.436663546518834,266,231,2066,-1835
sn19.2,4.376269049366499e-05,34,23,3589,-3566
sn19.3,4.376269049366499e-05,34,23,3590,-3567
sn19.4,4.376269049366499e-05,35,28,3704,-3676
sn19.5,4.376269049366499e-05,35,28,3621,-3593
sn19.6,4.376269049366499e-05,35,28,3552,-3524
sn19.7,4.376269049366499e-05,35,28,3625,-3597
sn19.8,4.376269049366499e-05,35,28,3551,-3523
sn19.9,4.376269049366499e-05,54,24,3889,-3865
sn19.10,4.376269051586945e-05,68,21,3495,-3474
sn19.11,4.376269049366499e-05,31,49,3515,-3466
sn19.12,4.376269051586945e-05,43,34,3264,-3230
sn19.13,4.376269049366499e-05,35,25,3621,-3596
sn19.14,4.376269049366499e-05,36,23,3630,-3607
sn19.15,4.376269051586945e-05,34,27,3557,-3530
sn19.16,4.376269051586945e-05,43,22,3473,-3451
sn19.17,4.376269049366499e-05,44,35,3604,-3569
sn19.18,4.376269049366499e-05,15,24,4175,-4151
sn19.19,4.376269049366499e-05,15,23,4190,-4167
sn19.20,4.376269049366499e-05,15,22,4228,-4206
sn19.21,0.25945371549191965,164,62,2388,-2326
sn20.1,0.3635185435271415,60,110,2158,-2048
sn20.2,0.18447783893995595,84,97,2650,-2553
sn20.3,0.15139192811981506,71,90,2759,-2669
sn20.4,4.376269051586945e-05,61,67,3155,-3088
sn20.5,0.2345269384212756,114,53,2831,-2778
sn20.6,0.20607674823793776,115,12,2698,-2686
sn20.7,0.31429415462864707,124,19,2275,-2256
sn20.8,0.11212605410850784,113,31,2973,-2942
sn20.9,0.34945677858357893,274,46,2261,-2215
sn20.10,0.3303099631614126,202,26,2274,-2248
sn20.11,0.25319691849692294,68,70,2448,-2378
sn20.12,0.140639001338827,60,14,2793,-2779
sn21.1,0.4179930210386429,166,326,1994,-1668
sn21.2,0.3794853738865678,112,241,2118,-1877
sn21.3,0.38047196682391426,279,231,2116,-1885
sn21.4,0.6634785069005611,202,223,1685,-1462
sn21.5,0.3459245230238883,65,110,2206,-2096
sn21.6,0.4066733524199728,94,73,2085,-2012
sn21.7,0.1540944722157711,142,53,2664,-2611
sn21.8,0.10197327804468692,105,22,2757,-2735
sn21.9,0.34176897712339116,107,51,2212,-2161
sn21.10,0.3049875171476035,232,41,2289,-2248
sn21.11,0.4379795829348998,92,79,1984,-1905
sn21.12,0.5018894653799011,117,65,1872,-1807
sn22.1,0.5729030526779644,733,281,1702,-1421
sn22.2,0.725481551483731,593,235,1560,-1325
sn22.3,0.42695748207515205,545,100,1887,-1787
sn22.4,0.6164352727638933,140,175,1751,-1576
sn22.5,0.24161652418601687,309,189,2455,-2266
sn22.6,4.376269051586945e-05,34,99,3285,-3186
sn22.7,0.25523189376295274,442,127,2418,-2291
sn22.8,0.2504557880917524,134,228,2372,-2144
sn22.9,4.376269051586945e-05,88,178,3039,-2861
sn22.10,4.376269051586945e-05,63,161,2892,-2731
sn22.11,0.20045898016787245,74,126,2596,-2470
sn22.12,4.376269051586945e-05,53,203,3190,-2987
sn22.13,4.376269051586945e-05,20,325,2881,-2556
sn22.14,4.376269051586945e-05,44,165,3192,-3027
sn22.15,4.376269051586945e-05,78,247,3169,-2922
sn22.16,4.376269049366499e-05,53,274,2938,-2664
sn22.17,4.376269051586945e-05,48,195,3084,-2889
sn22.18,4.376269056027837e-05,77,174,2785,-2611
sn22.19,0.29339707672779713,51,298,2270,-1972
sn22.20,4.376269051586945e-05,51,144,2757,-2613
sn22.21,0.29603595035629926,103,139,2359,-2220
sn22.22,0.2930028936563467,100,148,2376,-2228
sn22.23,0.2539730562526987,48,136,2553,-2417
sn22.24,4.376269051586945e-05,56,37,3925,-3888
sn22.25,0.11522122673324198,78,129,2945,-2816
sn22.26,0.5009853471026782,224,232,1907,-1675
sn22.27,0.1230266510372946,130,83,2861,-2778
sn22.28,0.08898559442187537,222,191,3115,-2924
sn22.29,4.376269051586945e-05,81,191,3312,-3121
sn22.30,4.376269049366499e-05,77,118,3620,-3502
sn22.31,0.10459756930967234,40,72,2991,-2919
sn22.32,0.12461910538512644,65,50,2979,-2929
sn22.33,0.173453674391566,153,92,2926,-2834
sn22.34,4.376269051586945e-05,64,81,3395,-3314
sn22.35,0.29316390183000696,233,91,2439,-2348
sn22.36,0.08415939969388386,237,35,3295,-3260
sn22.37,0.046031938055146604,140,96,3331,-3235
sn22.38,0.06096643719855077,430,26,3137,-3111
sn22.39,0.05683902114015371,78,52,3508,-3456
sn22.40,0.008814108989541047,16,139,2629,-2490
sn22.41,4.376269056027837e-05,16,127,2657,-2530
sn22.42,0.13631286048876312,80,82,2970,-2888
sn22.43,0.58065806996066,272,298,1833,-1535
sn22.44,0.24139226193096164,154,251,2380,-2129
sn22.45,0.1787492281088543,114,277,2568,-2291
sn22.46,0.30074488939504374,104,261,2340,-2079
sn22.47,0.190841502932515,160,33,2927,-2894
sn22.48,0.3933018009845135,173,138,2107,-1969
sn22.49,0.22169312590702983,339,154,2634,-2480
sn22.50,0.3246162749395154,172,132,2309,-2177
sn22.51,4.376269051586945e-05,94,66,3066,-3000
sn22.52,0.22765384944956057,138,130,2568,-2438
sn22.53,0.17376862930496006,135,87,2698,-2611
sn22.54,0.2726924823624133,219,64,2353,-2289
sn22.55,0.23953337052862178,531,344,2458,-2114
sn22.56,0.6308316431650196,512,513,1698,-1185
sn22.57,0.6643457373413097,633,470,1686,-1216
sn22.58,0.3049271082131044,156,124,2286,-2162
sn22.59,0.45052589056147063,454,337,1940,-1603
sn22.60,0.198548570168966,392,100,2626,-2526
sn22.61,4.376269049366499e-05,45,145,3069,-2924
sn22.62,0.07384374728502952,323,8,3562,-3554
sn22.63,0.328113221305526,205,82,2264,-2182
sn22.64,0.06181801935944975,136,64,3113,-3049
sn22.65,0.03699757189175035,133,52,3139,-3087
sn22.66,0.2652674797043231,134,237,2359,-2122
sn22.67,0.309383526221807,132,239,2280,-2041
sn22.68,0.30095044302527185,132,195,2302,-2107
sn22.69,0.19350417597070457,130,149,2607,-2458
sn22.70,0.20376595140052522,134,138,2592,-2454
sn22.71,0.5630594617243689,119,265,1776,-1511
sn22.72,0.4643055829706144,149,218,1869,-1651
sn22.73,4.376269049366499e-05,45,206,3508,-3302
sn22.74,4.376269051586945e-05,53,153,3570,-3417
sn22.75,4.376269051586945e-05,26,193,3235,-3042
sn22.76,0.5147165538940568,170,220,1890,-1670
sn22.77,0.05432027148923879,68,248,2711,-2463
sn22.78,0.4721427300672376,231,92,1840,-1748
sn22.79,0.5135308927247451,812,251,1850,-1599
sn22.80,0.607739306382804,547,136,1465,-1329
sn22.81,0.40776789434990857,1002,105,2048,-1943
sn22.82,1.0793812877235132,864,411,921,-510
sn22.83,0.23955272248443737,173,354,2568,-2214
sn22.84,0.6470702144121043,514,100,1580,-1480
sn22.85,0.5960145667395222,1185,659,1762,-1103
sn22.86,0.5096449325754593,634,358,1831,-1473
sn22.87,0.5217965980847561,978,173,1906,-1733
sn22.88,0.37713706402791036,400,65,2141,-2076
sn22.89,0.3442368266671769,1026,227,2239,-2012
sn22.90,0.7650474220666004,594,483,1360,-877
sn22.91,0.5889789999188322,117,233,1741,-1508
sn22.92,0.5695573949823229,133,207,1727,-1520
sn22.93,0.10883590128851761,179,86,3254,-3168
sn22.94,0.1581462563667424,282,64,2821,-2757
sn22.95,0.2753493147543473,469,78,2524,-2446
sn22.96,0.42083242279009614,519,51,1947,-1896
sn22.97,0.2976900613084643,334,170,2302,-2132
sn22.98,0.2892718729275101,86,170,2300,-2130
sn22.99,0.18253677119604017,283,97,2685,-2588
sn22.100,0.3787672365604511,288,122,2112,-1990
sn22.101,0.5514522135833477,481,110,1815,-1705
sn22.102,0.1491786998787603,337,117,2893,-2776
sn22.103,0.39991598997877187,76,197,2054,-1857
sn22.104,0.4456340799731118,75,455,1993,-1538
sn22.105,0.32592073445045777,75,292,2241,-1949
sn22.106,0.34925499948725847,61,196,2195,-1999
sn22.107,0.3132232738776164,36,185,2318,-2133
sn22.108,0.21472740765491327,38,158,2768,-2610
sn22.109,0.3302756948756924,33,212,2244,-2032
sn22.110,0.26726302369424193,39,136,2485,-2349
sn22.111,0.2014470651453104,52,183,2670,-2487
sn22.112,0.258468552197777,82,174,2385,-2211
sn22.113,0.38472896509638144,65,105,2138,-2033
sn22.114,0.420167496992252,54,211,2066,-1855
sn22.115,0.3701882202265194,97,145,2160,-2015
sn22.116,0.3868968217081159,103,170,2123,-1953
sn22.117,0.0997359046044588,182,45,2903,-2858
sn22.118,4.376269049366499e-05,72,238,3051,-2813
sn22.119,4.376269051586945e-05,67,176,3256,-3080
sn22.120,0.38536207842170267,50,232,2080,-1848
sn22.121,0.41017232894715594,50,258,2009,-1751
sn22.122,0.2260254310293197,272,148,2571,-2423
sn22.123,0.3160622403520774,181,145,2272,-2127
sn22.124,0.5452321768719015,127,209,1768,-1559
sn22.125,0.5806203365897877,127,199,1615,-1416
sn22.126,0.2637959805885215,224,251,2462,-2211
sn22.127,0.31267382126334287,115,206,2266,-2060
sn22.128,0.2621149843481829,100,184,2372,-2188
sn22.129,0.1738973003860833,58,258,2528,-2270
sn22.130,4.376269053807391e-05,50,252,2962,-2710
sn22.131,4.376269051586945e-05,54,213,3024,-2811
sn22.132,0.16607895444751275,62,260,2530,-2270
sn22.133,0.20468248390019816,112,301,2527,-2226
sn22.134,0.1290629931231635,107,244,2814,-2570
sn22.135,0.4086335341251024,124,267,2003,-1736
sn22.136,4.376269049366499e-05,44,120,3264,-3144
sn22.137,4.376269051586945e-05,40,233,2933,-2700
sn22.138,4.376269049366499e-05,38,236,2913,-2677
sn22.139,4.376269051586945e-05,38,236,2955,-2719
sn22.140,4.376269051586945e-05,18,243,2876,-2633
sn22.141,4.376269049366499e-05,18,240,2856,-2616
sn22.142,4.376269051586945e-05,18,232,2903,-2671
sn22.143,0.08258757846677511,39,179,2624,-2445
sn22.144,0.09250185219007445,39,180,2608,-2428
sn22.145,0.0736358194183051,39,176,2649,-2473
sn22.146,4.376269051586945e-05,76,93,3679,-3586
sn22.147,4.376269049366499e-05,24,90,3400,-3310
sn22.148,4.376269049366499e-05,24,85,3436,-3351
sn22.149,4.376269051586945e-05,85,84,3527,-3443
sn22.150,0.33104337798919303,125,311,2325,-2014
sn22.151,0.27499141146358763,116,246,2410,-2164
sn22.152,0.3023052424544037,182,270,2355,-2085
sn22.153,0.24727213061594977,177,224,2487,-2263
sn22.154,0.31132043924901875,114,312,2259,-1947
sn22.155,0.21012026733322475,106,233,2466,-2233
sn22.156,0.19339861997245134,106,201,2593,-2392
sn22.157,0.3147574497591288,82,203,2289,-2086
sn22.158,0.2741606657587381,79,135,2334,-2199
sn22.159,0.6122479503198219,131,294,1778,-1484
sn23.1,0.3517865496461381,163,80,2192,-2112
sn23.2,0.36070844817917,155,86,2172,-2086
sn23.3,0.38219688674732133,58,108,2126,-2018
sn23.4,0.47081957554744314,95,130,1912,-1782
sn23.5,0.2808600476995826,107,191,2396,-2205
sn23.6,0.41309033358172265,44,210,2058,-1848
sn23.7,0.40925759677781226,39,214,1950,-1736
sn23.8,0.3601919911415452,45,161,2154,-1993
sn23.9,0.23151697025740603,95,251,2526,-2275
sn23.10,0.2884220682637162,122,162,2313,-2151
sn23.11,0.2160157621550196,61,194,2491,-2297
sn23.12,0.16382227002202931,37,77,2693,-2616
sn23.13,0.29585354321877144,37,293,2273,-1980
sn23.14,0.16103080797360558,37,70,2701,-2631
sn23.15,0.42897248479178973,37,385,2079,-1694
sn23.16,0.16103080797360558,37,70,2701,-2631
sn23.17,0.20175517880371974,37,146,2546,-2400
sn23.18,0.16103080797360558,37,70,2701,-2631
sn23.19,0.16198807271343707,37,71,2697,-2626
sn23.20,0.16198807271343707,37,71,2697,-2626
sn23.21,0.16103080797360558,37,70,2701,-2631
sn23.22,0.2896449960189562,53,57,2393,-2336
sn23.23,0.17491027078322396,179,151,2905,-2754
sn23.24,0.17491027078322396,179,151,2905,-2754
sn23.25,0.17491027078322396,179,151,2905,-2754
sn23.26,0.17491027078322396,179,151,2905,-2754
sn23.27,0.17491027078322396,179,151,2905,-2754
sn23.28,0.17491027078322396,179,151,2905,-2754
sn23.29,0.17491027078322396,179,151,2905,-2754
sn23.30,0.17491027078322396,179,151,2905,-2754
sn23.31,0.17491027078322396,179,151,2905,-2754
sn23.32,0.17491027078322396,179,151,2905,-2754
sn23.33,0.17491027078322396,179,151,2905,-2754
sn23.34,0.292363626569081,112,105,2399,-2294
sn23.35,0.044896835625363174,135,138,3196,-3058
sn23.36,0.044896835625363174,135,138,3196,-3058
sn23.37,0.044896835625363174,135,138,3196,-3058
sn23.38,0.044896835625363174,135,138,3196,-3058
sn23.39,0.044896835625363174,135,138,3196,-3058
sn23.40,0.044896835625363174,135,138,3196,-3058
sn23.41,0.044896835625363174,135,138,3196,-3058
sn23.42,0.044896835625363174,135,138,3196,-3058
sn23.43,0.044896835625363174,135,138,3196,-3058
sn23.44,0.044896835625363174,135,138,3196,-3058
sn23.45,0.044896835625363174,135,138,3196,-3058
sn23.46,0.22902743594335195,87,104,2640,-2536
sn24.1,0.41737686809055763,325,143,2025,-1882
sn24.2,0.49364583717463884,187,298,1853,-1555
sn24.3,0.46958286643759006,212,284,1866,-1582
sn24.4,0.38294453441607423,214,168,2125,-1957
sn24.5,0.6175098990930605,339,450,1703,-1253
sn24.6,0.2712361436403743,291,138,2437,-2299
sn24.7,0.5800557568763853,245,227,1743,-1516
sn24.8,0.4475188079191339,369,166,1845,-1679
sn24.9,0.4697179583215805,176,272,1894,-1622
sn24.10,0.5289545374185023,109,213,1902,-1689
sn24.11,0.27829433556345595,24,177,2276,-2099
sn24.12,0.27829433556345595,24,177,2276,-2099
sn24.13,0.25546914929459597,26,161,2313,-2152
sn24.14,0.2499284998824125,26,190,2320,-2130
sn24.15,0.36479846051811204,26,380,2170,-1790
sn24.16,0.36479846051811204,27,380,2170,-1790
sn24.17,0.36479846051811204,30,380,2170,-1790
sn24.18,0.7027018720766831,209,547,1605,-1058
sn24.19,0.16686645710932702,193,103,2814,-2711
sn24.20,4.376269049366499e-05,5,69,4281,-4212
sn24.21,4.376269049366499e-05,5,69,4281,-4212
sn24.22,4.376269049366499e-05,5,69,4281,-4212
sn24.23,4.376269049366499e-05,5,69,4281,-4212
sn24.24,4.376269049366499e-05,5,69,4281,-4212
sn24.25,4.376269049366499e-05,5,69,4281,-4212
sn24.26,4.376269049366499e-05,5,69,4281,-4212
sn24.27,4.376269049366499e-05,5,69,4281,-4212
sn24.28,4.376269049366499e-05,5,69,4281,-4212
sn24.29,4.376269049366499e-05,5,69,4281,-4212
sn24.30,4.376269049366499e-05,5,69,4281,-4212
sn24.31,4.376269049366499e-05,5,69,4281,-4212
sn24.32,4.376269049366499e-05,5,69,4281,-4212
sn24.33,4.376269049366499e-05,5,69,4281,-4212
sn24.34,4.376269049366499e-05,5,69,4281,-4212
sn24.35,4.376269049366499e-05,5,69,4281,-4212
sn24.36,0.38040978219617827,179,567,2131,-1564
sn24.37,0.23689038856615774,141,488,2424,-1936
sn24.38,4.376269051586945e-05,20,296,2589,-2293
sn24.39,4.376269049366499e-05,13,381,3271,-2890
sn24.40,4.376269049366499e-05,11,351,3567,-3216
sn24.41,4.376269049366499e-05,9,369,3774,-3405
sn24.42,4.376269049366499e-05,9,367,3776,-3409
sn24.43,4.376269049366499e-05,9,369,3774,-3405
sn24.44,0.3429342241843658,214,360,2221,-1861
sn24.45,0.18813029076707455,188,119,2719,-2600
sn24.46,4.376269049366499e-05,5,66,4288,-4222
sn24.47,4.376269049366499e-05,5,66,4288,-4222
sn24.48,4.376269049366499e-05,5,66,4288,-4222
sn24.49,4.376269049366499e-05,5,66,4288,-4222
sn24.50,4.376269049366499e-05,5,66,4288,-4222
sn24.51,4.376269049366499e-05,5,66,4288,-4222
sn24.52,4.376269049366499e-05,5,66,4288,-4222
sn24.53,4.376269049366499e-05,5,66,4288,-4222
sn24.54,4.376269049366499e-05,5,66,4288,-4222
sn24.55,4.376269049366499e-05,5,66,4288,-4222
sn24.56,4.376269049366499e-05,5,66,4288,-4222
sn24.57,4.376269049366499e-05,5,66,4288,-4222
sn24.58,4.376269049366499e-05,5,66,4288,-4222
sn24.59,4.376269049366499e-05,5,66,4288,-4222
sn24.60,4.376269049366499e-05,5,66,4288,-4222
sn24.61,4.376269049366499e-05,5,66,4288,-4222
sn24.62,4.376269049366499e-05,5,66,4288,-4222
sn24.63,4.376269049366499e-05,5,66,4288,-4222
sn24.64,4.376269049366499e-05,5,66,4288,-4222
sn24.65,4.376269049366499e-05,5,66,4288,-4222
sn24.66,4.376269049366499e-05,5,66,4288,-4222
sn24.67,4.376269049366499e-05,5,66,4288,-4222
sn24.68,4.376269049366499e-05,5,66,4288,-4222
sn24.69,4.376269049366499e-05,5,66,4288,-4222
sn24.70,0.27161138306042165,170,476,2342,-1866
sn24.71,0.4623494464175426,240,325,1979,-1654
sn24.72,4.376269049366499e-05,5,66,4288,-4222
sn24.73,4.376269049366499e-05,5,66,4288,-4222
sn24.74,4.376269049366499e-05,5,66,4288,-4222
sn24.75,4.376269049366499e-05,5,66,4288,-4222
sn24.76,4.376269049366499e-05,5,66,4288,-4222
sn24.77,4.376269049366499e-05,5,66,4288,-4222
sn24.78,4.376269049366499e-05,5,66,4288,-4222
sn24.79,4.376269049366499e-05,5,66,4288,-4222
sn24.80,4.376269049366499e-05,5,66,4288,-4222
sn24.81,4.376269049366499e-05,5,66,4288,-4222
sn24.82,4.376269049366499e-05,5,66,4288,-4222
sn24.83,4.376269049366499e-05,5,66,4288,-4222
sn24.84,4.376269049366499e-05,5,66,4288,-4222
sn24.85,4.376269049366499e-05,5,66,4288,-4222
sn24.86,4.376269049366499e-05,5,66,4288,-4222
sn24.87,4.376269049366499e-05,5,66,4288,-4222
sn24.88,4.376269049366499e-05,5,66,4288,-4222
sn24.89,4.376269049366499e-05,5,66,4288,-4222
sn24.90,4.376269049366499e-05,5,66,4288,-4222
sn24.91,4.376269049366499e-05,5,66,4288,-4222
sn24.92,4.376269049366499e-05,5,66,4288,-4222
sn24.93,4.376269049366499e-05,5,66,4288,-4222
sn24.94,4.376269049366499e-05,5,66,4288,-4222
sn24.95,4.376269049366499e-05,5,66,4288,-4222
sn24.96,0.637834407961213,261,341,1715,-1374
sn25.1,0.3725025238077606,119,129,2154,-2025
sn25.2,0.3149436969267283,120,100,2275,-2175
sn25.3,4.376269049366499e-05,24,102,3159,-3057
sn25.4,0.2705359212773706,32,99,2539,-2440
sn25.5,0.2035601553328492,46,199,2826,-2627
sn25.6,0.27672203573951837,32,73,2424,-2351
sn25.7,0.24415422432215728,32,74,2536,-2462
sn25.8,0.28001960679653326,32,75,2406,-2331
sn25.9,0.24872053897293522,32,80,2590,-2510
sn25.10,0.5586947231085881,129,166,1687,-1521
sn26.1,4.376269051586945e-05,91,97,3415,-3318
sn26.2,4.376269051586945e-05,76,117,3538,-3421
sn26.3,4.376269051586945e-05,46,135,3346,-3211
sn26.4,4.376269051586945e-05,46,152,3420,-3268
sn26.5,4.376269051586945e-05,53,154,3159,-3005
sn26.6,4.376269051586945e-05,52,56,3710,-3654
sn26.7,4.376269049366499e-05,52,60,3549,-3489
sn26.8,4.376269051586945e-05,52,56,3710,-3654
sn26.9,4.376269051586945e-05,76,132,3660,-3528
sn26.10,4.376269056027837e-05,85,130,3144,-3014
sn27.1,0.12713850853423025,53,90,3038,-2948
sn27.2,0.23789277803329956,45,149,2539,-2390
sn27.3,0.19547398525991966,45,171,2777,-2606
sn27.4,4.376269053807391e-05,34,150,3299,-3149
sn27.5,0.04467199725965987,40,189,3038,-2849
sn27.6,4.376269051586945e-05,34,141,2999,-2858
sn27.7,4.376269051586945e-05,34,98,3401,-3303
sn27.8,4.376269051586945e-05,34,140,3025,-2885
sn27.9,0.21666966287121614,45,151,2641,-2490
sn27.10,0.40688361639915627,51,116,2056,-1940
sn28.1,0.31228118336772415,134,294,2304,-2010
sn28.2,0.25192171968941857,89,221,2603,-2382
sn28.3,0.23080594311075675,95,209,2483,-2274
sn28.4,0.2695253303116596,87,235,2354,-2119
sn28.5,4.376269051586945e-05,27,149,2572,-2423
sn28.6,4.376269051586945e-05,23,154,2828,-2674
sn28.7,4.376269051586945e-05,23,194,2759,-2565
sn28.8,4.376269051586945e-05,20,230,2517,-2287
sn28.9,0.20253733591963918,59,169,2636,-2467
sn28.10,0.26504813766294877,264,26,2627,-2601
sn29.1,4.376269051586945e-05,19,83,3673,-3590
sn29.2,4.376269051586945e-05,57,57,3741,-3684
sn29.3,0.15026688444008673,121,312,2754,-2442
sn29.4,0.11872071215992541,50,212,2587,-2375
sn29.5,0.11488440742446482,41,213,2639,-2426
sn29.6,0.11327726356209489,102,321,2919,-2598
sn29.7,0.16892981073077795,82,407,2617,-2210
sn29.8,0.12070763857157107,44,454,2530,-2076
sn29.9,0.12070763857157107,44,454,2530,-2076
sn29.10,0.1761963284999224,80,415,2593,-2178
sn29.11,0.08068191430734561,145,393,3042,-2649
sn29.12,0.08068191430734561,145,393,3042,-2649
sn29.13,0.08068191430734561,145,393,3042,-2649
sn29.14,0.08068191430734561,145,393,3042,-2649
sn29.15,0.08068191430734561,145,393,3042,-2649
sn29.16,0.08068191430734561,145,393,3042,-2649
sn29.17,0.08068191430734561,145,393,3042,-2649
sn29.18,0.08068191430734561,145,393,3042,-2649
sn29.19,0.08068191430734561,145,393,3042,-2649
sn29.20,0.08068191430734561,145,393,3042,-2649
sn29.21,0.2978168504229606,138,377,2339,-1962
sn29.22,0.2978168504229606,138,377,2339,-1962
sn29.23,0.2978168504229606,138,377,2339,-1962
sn29.24,0.2978168504229606,138,377,2339,-1962
sn29.25,0.2978168504229606,138,377,2339,-1962
sn29.26,0.2978168504229606,138,377,2339,-1962
sn29.27,0.2978168504229606,138,377,2339,-1962
sn29.28,0.2978168504229606,138,377,2339,-1962
sn29.29,0.2978168504229606,138,377,2339,-1962
sn29.30,0.2978168504229606,138,377,2339,-1962
sn29.31,0.2978168504229606,138,377,2339,-1962
sn29.32,0.2978168504229606,138,377,2339,-1962
sn29.33,0.2978168504229606,138,377,2339,-1962
sn29.34,0.2978168504229606,138,377,2339,-1962
sn29.35,0.2978168504229606,138,377,2339,-1962
sn29.36,0.2978168504229606,138,377,2339,-1962
sn29.37,0.2978168504229606,138,377,2339,-1962
sn29.38,0.2978168504229606,138,377,2339,-1962
sn29.39,0.2978168504229606,138,377,2339,-1962
sn29.40,0.2978168504229606,138,377,2339,-1962
sn29.41,0.2978168504229606,138,377,2339,-1962
sn29.42,0.2978168504229606,138,377,2339,-1962
sn29.43,0.2978168504229606,138,377,2339,-1962
sn29.44,0.2978168504229606,138,377,2339,-1962
sn29.45,0.2978168504229606,138,377,2339,-1962
sn29.46,0.2978168504229606,138,377,2339,-1962
sn29.47,0.2978168504229606,138,377,2339,-1962
sn29.48,0.2978168504229606,138,377,2339,-1962
sn29.49,0.2978168504229606,138,377,2339,-1962
sn29.50,0.2978168504229606,138,377,2339,-1962
sn30.1,4.376269049366499e-05,19,84,3697,-3613
sn30.2,4.376269051586945e-05,76,18,3798,-3780
sn30.3,0.1910564511435231,91,419,2501,-2082
sn30.4,0.15629960385221686,91,395,2677,-2282
sn30.5,0.15629960385221686,91,395,2677,-2282
sn30.6,0.15629960385221686,91,395,2677,-2282
sn30.7,0.13576774876531417,113,389,2795,-2406
sn30.8,0.13576774876531417,113,389,2795,-2406
sn30.9,0.13576774876531417,113,389,2795,-2406
sn30.10,0.13576774876531417,113,389,2795,-2406
sn30.11,0.13576774876531417,113,389,2795,-2406
sn30.12,0.13576774876531417,113,389,2795,-2406
sn30.13,0.13576774876531417,113,389,2795,-2406
sn30.14,0.13576774876531417,113,389,2795,-2406
sn30.15,0.13576774876531417,113,389,2795,-2406
sn30.16,0.13576774876531417,113,389,2795,-2406
sn30.17,0.3037027495496947,115,391,2322,-1931
sn30.18,0.3037027495496947,115,391,2322,-1931
sn30.19,0.3037027495496947,115,391,2322,-1931
sn30.20,0.3037027495496947,115,391,2322,-1931
sn30.21,0.3037027495496947,115,391,2322,-1931
sn30.22,0.3037027495496947,115,391,2322,-1931
sn30.23,0.3037027495496947,115,391,2322,-1931
sn30.24,0.3037027495496947,115,391,2322,-1931
sn30.25,0.3037027495496947,115,391,2322,-1931
sn30.26,0.3037027495496947,115,391,2322,-1931
sn30.27,0.3037027495496947,115,391,2322,-1931
sn30.28,0.3037027495496947,115,391,2322,-1931
sn30.29,0.3037027495496947,115,391,2322,-1931
sn30.30,0.3037027495496947,115,391,2322,-1931
sn30.31,0.3037027495496947,115,391,2322,-1931
sn30.32,0.3037027495496947,115,391,2322,-1931
sn30.33,0.3037027495496947,115,391,2322,-1931
sn30.34,0.3037027495496947,115,391,2322,-1931
sn30.35,0.3037027495496947,115,391,2322,-1931
sn30.36,0.3037027495496947,115,391,2322,-1931
sn30.37,0.3037027495496947,115,391,2322,-1931
sn30.38,0.3037027495496947,115,391,2322,-1931
sn30.39,0.3037027495496947,115,391,2322,-1931
sn30.40,0.3037027495496947,115,391,2322,-1931
sn30.41,0.3037027495496947,115,391,2322,-1931
sn30.42,0.3037027495496947,115,391,2322,-1931
sn30.43,0.3037027495496947,115,391,2322,-1931
sn30.44,0.3037027495496947,115,391,2322,-1931
sn30.45,0.3037027495496947,115,391,2322,-1931
sn30.46,0.3037027495496947,115,391,2322,-1931
sn31.1,0.07012269529913517,80,206,3397,-3191
sn31.2,0.16029997939821516,83,410,2693,-2283
sn31.3,0.16021161510846316,93,399,2661,-2262
sn31.4,0.08996749671357218,202,301,3379,-3078
sn31.5,0.08996749671357218,202,301,3379,-3078
sn31.6,0.08996749671357218,202,301,3379,-3078
sn31.7,0.08996749671357218,202,301,3379,-3078
sn31.8,0.08996749671357218,202,301,3379,-3078
sn31.9,0.08996749671357218,202,301,3379,-3078
sn31.10,0.08996749671357218,202,301,3379,-3078
sn31.11,0.08996749671357218,202,301,3379,-3078
sn31.12,0.08996749671357218,202,301,3379,-3078
sn31.13,0.13937904055698613,120,388,2814,-2426
sn31.14,0.13937904055698613,120,388,2814,-2426
sn31.15,0.13937904055698613,120,388,2814,-2426
sn31.16,0.13937904055698613,120,388,2814,-2426
sn31.17,0.13937904055698613,120,388,2814,-2426
sn31.18,0.13937904055698613,120,388,2814,-2426
sn31.19,0.13937904055698613,120,388,2814,-2426
sn31.20,0.13937904055698613,120,388,2814,-2426
sn31.21,0.13937904055698613,120,388,2814,-2426
sn31.22,0.13937904055698613,120,388,2814,-2426
sn31.23,0.20954564023427658,171,356,2830,-2474
sn31.24,0.20954564023427658,171,356,2830,-2474
sn31.25,0.20954564023427658,171,356,2830,-2474
sn31.26,0.20954564023427658,171,356,2830,-2474
sn31.27,0.20954564023427658,171,356,2830,-2474
sn31.28,0.20954564023427658,171,356,2830,-2474
sn31.29,0.20954564023427658,171,356,2830,-2474
sn31.30,0.20954564023427658,171,356,2830,-2474
sn31.31,0.20954564023427658,171,356,2830,-2474
sn31.32,0.20954564023427658,171,356,2830,-2474
sn31.33,0.20954564023427658,171,356,2830,-2474
sn31.34,0.20954564023427658,171,356,2830,-2474
sn31.35,0.20954564023427658,171,356,2830,-2474
sn31.36,0.20954564023427658,171,356,2830,-2474
sn31.37,0.20954564023427658,171,356,2830,-2474
sn31.38,0.20954564023427658,171,356,2830,-2474
sn31.39,0.20954564023427658,171,356,2830,-2474
sn31.40,0.20954564023427658,171,356,2830,-2474
sn31.41,0.20954564023427658,171,356,2830,-2474
sn31.42,0.20954564023427658,171,356,2830,-2474
sn31.43,0.20954564023427658,171,356,2830,-2474
sn31.44,0.20954564023427658,171,356,2830,-2474
sn31.45,0.20954564023427658,171,356,2830,-2474
sn31.46,0.20954564023427658,171,356,2830,-2474
sn31.47,0.20954564023427658,171,356,2830,-2474
sn31.48,0.20954564023427658,171,356,2830,-2474
sn31.49,0.20954564023427658,171,356,2830,-2474
sn31.50,0.20954564023427658,171,356,2830,-2474
sn31.51,0.20954564023427658,171,356,2830,-2474
sn31.52,0.20954564023427658,171,356,2830,-2474
sn31.53,0.20954564023427658,171,356,2830,-2474
sn31.54,0.20954564023427658,171,356,2830,-2474
sn31.55,0.20954564023427658,171,356,2830,-2474
sn31.56,0.20954564023427658,171,356,2830,-2474
sn31.57,0.20954564023427658,171,356,2830,-2474
sn31.58,0.20954564023427658,171,356,2830,-2474
sn31.59,0.20954564023427658,171,356,2830,-2474
sn31.60,0.20954564023427658,171,356,2830,-2474
sn31.61,0.20954564023427658,171,356,2830,-2474
sn31.62,0.20954564023427658,171,356,2830,-2474
sn31.63,0.20954564023427658,171,356,2830,-2474
sn31.64,0.20954564023427658,171,356,2830,-2474
sn31.65,0.20954564023427658,171,356,2830,-2474
sn31.66,0.20954564023427658,171,356,2830,-2474
sn31.67,0.20954564023427658,171,356,2830,-2474
sn31.68,0.20954564023427658,171,356,2830,-2474
sn31.69,0.20954564023427658,171,356,2830,-2474
sn31.70,0.20954564023427658,171,356,2830,-2474
sn31.71,0.20954564023427658,171,356,2830,-2474
sn31.72,0.20954564023427658,171,356,2830,-2474
sn31.73,0.20954564023427658,171,356,2830,-2474
sn31.74,0.20954564023427658,171,356,2830,-2474
sn31.75,0.20954564023427658,171,356,2830,-2474
sn31.76,0.20954564023427658,171,356,2830,-2474
sn31.77,0.20954564023427658,171,356,2830,-2474
sn31.78,0.20954564023427658,171,356,2830,-2474
sn31.79,0.20954564023427658,171,356,2830,-2474
sn31.80,0.20954564023427658,171,356,2830,-2474
sn31.81,0.20954564023427658,171,356,2830,-2474
sn31.82,0.20954564023427658,171,356,2830,-2474
sn31.83,0.20954564023427658,171,356,2830,-2474
sn31.84,0.20954564023427658,171,356,2830,-2474
sn31.85,0.20954564023427658,171,356,2830,-2474
sn31.86,0.20954564023427658,171,356,2830,-2474
sn31.87,0.20954564023427658,171,356,2830,-2474
sn31.88,0.20954564023427658,171,356,2830,-2474
sn31.89,0.20954564023427658,171,356,2830,-2474
sn31.90,0.20954564023427658,171,356,2830,-2474
sn31.91,0.20954564023427658,171,356,2830,-2474
sn31.92,0.20954564023427658,171,356,2830,-2474
sn31.93,0.20954564023427658,171,356,2830,-2474
sn31.94,0.20954564023427658,171,356,2830,-2474
sn31.95,0.20954564023427658,171,356,2830,-2474
sn31.96,0.20954564023427658,171,356,2830,-2474
sn31.97,0.20954564023427658,171,356,2830,-2474
sn31.98,0.20954564023427658,171,356,2830,-2474
sn31.99,0.20954564023427658,171,356,2830,-2474
sn31.100,0.20954564023427658,171,356,2830,-2474
sn31.101,0.20954564023427658,171,356,2830,-2474
sn31.102,0.20954564023427658,171,356,2830,-2474
sn31.103,0.20954564023427658,171,356,2830,-2474
sn31.104,0.20954564023427658,171,356,2830,-2474
sn31.105,0.20954564023427658,171,356,2830,-2474
sn31.106,0.20954564023427658,171,356,2830,-2474
sn31.107,0.20954564023427658,171,356,2830,-2474
sn31.108,0.20954564023427658,171,356,2830,-2474
sn31.109,0.20954564023427658,171,356,2830,-2474
sn31.110,0.20954564023427658,171,356,2830,-2474
sn31.111,0.20954564023427658,171,356,2830,-2474
sn31.112,0.20954564023427658,171,356,2830,-2474
sn32.1,4.376269051586945e-05,33,104,3124,-3020
sn32.2,0.15285239513505022,83,398,2703,-2305
sn32.3,0.15589323082370043,91,402,2691,-2289
sn32.4,0.15589323082370043,91,402,2691,-2289
sn32.5,0.15589323082370043,91,402,2691,-2289
sn32.6,0.15589323082370043,91,402,2691,-2289
sn32.7,0.15589323082370043,91,402,2691,-2289
sn32.8,0.15589323082370043,91,402,2691,-2289
sn32.9,0.15589323082370043,91,402,2691,-2289
sn32.10,0.15589323082370043,91,402,2691,-2289
sn32.11,0.15589323082370043,91,402,2691,-2289
sn32.12,0.15589323082370043,91,402,2691,-2289
sn32.13,0.12764473796689213,106,376,2915,-2539
sn32.14,0.12764473796689213,106,376,2915,-2539
sn32.15,0.12764473796689213,106,376,2915,-2539
sn32.16,0.12764473796689213,106,376,2915,-2539
sn32.17,0.12764473796689213,106,376,2915,-2539
sn32.18,0.12764473796689213,106,376,2915,-2539
sn32.19,0.12764473796689213,106,376,2915,-2539
sn32.20,0.12764473796689213,106,376,2915,-2539
sn32.21,0.12764473796689213,106,376,2915,-2539
sn32.22,0.12764473796689213,106,376,2915,-2539
sn32.23,0.12764473796689213,106,376,2915,-2539
sn32.24,0.12764473796689213,106,376,2915,-2539
sn32.25,0.12764473796689213,106,376,2915,-2539
sn32.26,0.12764473796689213,106,376,2915,-2539
sn32.27,0.12764473796689213,106,376,2915,-2539
sn32.28,0.12764473796689213,106,376,2915,-2539
sn32.29,0.12764473796689213,106,376,2915,-2539
sn32.30,0.12764473796689213,106,376,2915,-2539
sn32.31,0.12764473796689213,106,376,2915,-2539
sn32.32,0.12764473796689213,106,376,2915,-2539
sn32.33,0.12764473796689213,106,376,2915,-2539
sn32.34,0.12764473796689213,106,376,2915,-2539
sn32.35,0.12764473796689213,106,376,2915,-2539
sn32.36,0.12764473796689213,106,376,2915,-2539
sn32.37,0.12764473796689213,106,376,2915,-2539
sn32.38,0.12764473796689213,106,376,2915,-2539
sn32.39,0.12764473796689213,106,376,2915,-2539
sn32.40,0.12764473796689213,106,376,2915,-2539
sn32.41,0.12764473796689213,106,376,2915,-2539
sn32.42,0.12764473796689213,106,376,2915,-2539
sn32.43,0.12764473796689213,106,376,2915,-2539
sn32.44,0.12764473796689213,106,376,2915,-2539
sn32.45,0.12764473796689213,106,376,2915,-2539
sn32.46,0.12764473796689213,106,376,2915,-2539
sn32.47,0.12764473796689213,106,376,2915,-2539
sn32.48,0.12764473796689213,106,376,2915,-2539
sn32.49,0.12764473796689213,106,376,2915,-2539
sn32.50,0.12764473796689213,106,376,2915,-2539
sn32.51,0.12764473796689213,106,376,2915,-2539
sn32.52,0.12764473796689213,106,376,2915,-2539
sn32.53,0.17061045286062004,46,223,2525,-2302
sn32.54,0.17052746005690178,46,222,2526,-2304
sn32.55,0.1551892751046946,46,198,2577,-2379
sn32.56,0.1666031001131829,47,223,2538,-2315
sn32.57,0.4265433418087605,54,174,2066,-1892
sn33.1,0.2272474170976979,153,269,2483,-2214
sn33.2,0.19781317766895956,100,211,2578,-2367
sn33.3,0.16591887539654238,100,209,2648,-2439
sn33.4,0.28765041316698436,99,243,2358,-2115
sn33.5,0.21862752239927286,100,233,2518,-2285
sn33.6,0.2712811431388351,75,128,2355,-2227
sn33.7,0.2712811431388351,75,128,2355,-2227
sn33.8,0.2712811431388351,75,128,2355,-2227
sn33.9,0.2712811431388351,75,128,2355,-2227
sn33.10,0.2712811431388351,75,128,2355,-2227
sn33.11,4.376269049366499e-05,42,91,3275,-3184
sn33.12,4.376269049366499e-05,42,91,3275,-3184
sn33.13,4.376269049366499e-05,42,91,3275,-3184
sn33.14,4.376269049366499e-05,42,91,3275,-3184
sn33.15,4.376269049366499e-05,42,91,3275,-3184
sn33.16,0.1786902869472362,63,200,2481,-2281
sn33.17,0.1786902869472362,63,200,2481,-2281
sn33.18,0.1786902869472362,63,200,2481,-2281
sn33.19,0.1786902869472362,63,200,2481,-2281
sn33.20,0.1786902869472362,63,200,2481,-2281
sn33.21,4.376269051586945e-05,26,305,2954,-2649
sn33.22,4.376269051586945e-05,26,305,2954,-2649
sn33.23,4.376269051586945e-05,26,305,2954,-2649
sn33.24,4.376269051586945e-05,26,305,2954,-2649
sn33.25,4.376269051586945e-05,26,305,2954,-2649
sn33.26,4.376269051586945e-05,15,69,3539,-3470
sn33.27,4.376269051586945e-05,15,69,3539,-3470
sn33.28,4.376269051586945e-05,15,69,3539,-3470
sn33.29,4.376269051586945e-05,15,69,3539,-3470
sn33.30,4.376269051586945e-05,15,69,3539,-3470
sn33.31,4.376269051586945e-05,15,69,3561,-3492
sn33.32,4.376269051586945e-05,15,69,3561,-3492
sn33.33,4.376269051586945e-05,15,69,3561,-3492
sn33.34,4.376269051586945e-05,15,69,3561,-3492
sn33.35,4.376269051586945e-05,15,69,3561,-3492
sn33.36,4.376269049366499e-05,16,63,3759,-3696
sn33.37,4.376269049366499e-05,16,63,3759,-3696
sn33.38,4.376269049366499e-05,16,63,3759,-3696
sn33.39,4.376269049366499e-05,16,63,3759,-3696
sn33.40,4.376269049366499e-05,16,63,3759,-3696
sn33.41,4.376269049366499e-05,16,103,3254,-3151
sn33.42,4.376269049366499e-05,16,103,3254,-3151
sn33.43,4.376269049366499e-05,16,103,3254,-3151
sn33.44,4.376269049366499e-05,16,103,3254,-3151
sn33.45,4.376269049366499e-05,16,103,3254,-3151
sn33.46,4.376269051586945e-05,15,67,3607,-3540
sn33.47,4.376269051586945e-05,15,67,3607,-3540
sn33.48,4.376269051586945e-05,15,67,3607,-3540
sn33.49,4.376269051586945e-05,15,67,3607,-3540
sn33.50,4.376269051586945e-05,15,67,3607,-3540
sn33.51,0.3725385699392403,105,153,2115,-1962
sn33.52,0.3725385699392403,105,153,2115,-1962
sn33.53,0.3725385699392403,105,153,2115,-1962
sn33.54,0.3725385699392403,105,153,2115,-1962
sn33.55,0.19269242899231376,107,141,2678,-2537
sn34.1,0.17651910353813083,117,88,2831,-2743
sn34.2,0.1553530831494898,117,66,3030,-2964
sn34.3,0.15715903222945915,86,66,3010,-2944
sn34.4,0.1561726799929497,86,63,3017,-2954
sn34.5,0.1554165296637544,86,62,3020,-2958
sn34.6,0.15647714517259548,86,67,3015,-2948
sn34.7,0.18738188281608448,86,77,2796,-2719
sn34.8,0.1554165296637544,86,62,3020,-2958
sn34.9,0.1554165296637544,86,62,3020,-2958
sn34.10,0.15647714517259548,86,65,3014,-2949
sn34.11,0.18074661214539933,86,87,2826,-2739
sn34.12,0.1580574914587185,61,90,2950,-2860
sn34.13,0.1616412075048368,58,90,2928,-2838
sn34.14,0.16089471366045327,58,90,2933,-2843
sn34.15,0.1618587585450415,58,92,2925,-2833
sn34.16,0.18114419249344316,58,98,2789,-2691
sn34.17,0.16089471366045327,58,90,2933,-2843
sn34.18,0.16089471366045327,58,90,2933,-2843
sn34.19,0.17782236274181962,117,90,2827,-2737
sn34.20,0.12340469068858884,63,70,3137,-3067
sn34.21,0.12340469068858884,63,70,3137,-3067
sn34.22,0.12340469068858884,63,70,3137,-3067
sn34.23,0.12340469068858884,63,70,3137,-3067
sn34.24,0.12340469068858884,63,70,3137,-3067
sn34.25,0.12340469068858884,63,70,3137,-3067
sn34.26,0.12340469068858884,63,70,3137,-3067
sn34.27,0.12340469068858884,63,70,3137,-3067
sn34.28,0.07619521229724757,51,61,3357,-3296
sn34.29,0.07619521229724757,51,61,3357,-3296
sn34.30,0.07619521229724757,51,61,3357,-3296
sn34.31,0.07619521229724757,51,61,3357,-3296
sn34.32,0.07619521229724757,51,61,3357,-3296
sn34.33,0.07619521229724757,51,61,3357,-3296
sn34.34,0.07619521229724757,51,61,3357,-3296
sn34.35,4.376269049366499e-05,43,59,3980,-3921
sn34.36,4.376269049366499e-05,43,59,3980,-3921
sn34.37,4.376269049366499e-05,43,59,3980,-3921
sn34.38,4.376269049366499e-05,43,59,3980,-3921
sn34.39,4.376269049366499e-05,43,59,3980,-3921
sn34.40,4.376269049366499e-05,43,59,3980,-3921
sn34.41,4.376269051586945e-05,43,61,3975,-3914
sn34.42,4.376269051586945e-05,43,61,3975,-3914
sn34.43,4.376269051586945e-05,43,61,3975,-3914
sn34.44,4.376269051586945e-05,43,61,3975,-3914
sn34.45,4.376269051586945e-05,43,61,3975,-3914
sn34.46,0.10268474856152121,98,74,3279,-3205
sn34.47,0.10268474856152121,98,74,3279,-3205
sn34.48,0.10268474856152121,98,74,3279,-3205
sn34.49,0.10268474856152121,98,74,3279,-3205
sn34.50,4.376269051586945e-05,59,80,3711,-3631
sn34.51,4.376269051586945e-05,59,80,3711,-3631
sn34.52,4.376269051586945e-05,59,80,3711,-3631
sn34.53,4.376269051586945e-05,50,59,4048,-3989
sn34.54,4.376269051586945e-05,50,59,4048,-3989
sn34.55,0.2794924833567025,152,65,2514,-2449
sn35.1,0.12796091672415688,136,235,2852,-2617
sn35.2,4.376269049366499e-05,57,243,3434,-3191
sn35.3,4.376269049366499e-05,51,169,3599,-3430
sn35.4,4.376269049366499e-05,83,233,3163,-2930
sn35.5,4.376269049366499e-05,51,219,3275,-3056
sn35.6,4.376269049366499e-05,47,206,3402,-3196
sn35.7,4.376269049366499e-05,90,146,3289,-3143
sn35.8,4.376269049366499e-05,94,127,3189,-3062
sn35.9,4.376269049366499e-05,94,116,3352,-3236
sn35.10,4.376269051586945e-05,61,97,2922,-2825
sn35.11,4.376269049366499e-05,30,75,3266,-3191
sn35.12,0.11785045086052381,72,141,2729,-2588
sn35.13,0.4707028840709393,202,184,1940,-1756
sn35.14,0.5327113083674506,171,184,1858,-1674
sn35.15,4.376269051586945e-05,174,58,3105,-3047
sn35.16,0.06589875051832284,132,58,2866,-2808
sn35.17,0.047209261681313563,274,149,3469,-3320
sn35.18,0.08560871830056715,198,184,2879,-2695
sn35.19,4.376269049366499e-05,111,221,3442,-3221
sn35.20,4.376269049366499e-05,75,199,3334,-3135
sn35.21,4.376269049366499e-05,75,107,3433,-3326
sn35.22,4.376269051586945e-05,95,114,3369,-3255
sn35.23,0.3824447509733542,60,171,2125,-1954
sn35.24,0.06299796081437048,84,284,2750,-2466
sn35.25,0.08497859839835531,125,159,2944,-2785
sn35.26,0.06604717656926162,303,128,3318,-3190
sn35.27,0.13830619641372888,154,232,2610,-2378
sn35.28,0.17776922738133027,210,210,2660,-2450
sn35.29,0.16099590544529363,173,180,2739,-2559
sn35.30,0.09183584288132707,293,83,3416,-3333
sn35.31,0.11571813912163442,265,64,3246,-3182
sn35.32,0.3493017845212387,283,343,2193,-1850
sn35.33,0.2261534712704183,142,217,2560,-2343
sn35.34,0.2261534712704183,142,217,2560,-2343
sn35.35,0.2261534712704183,142,217,2560,-2343
sn35.36,0.2261534712704183,142,217,2560,-2343
sn35.37,0.2261534712704183,142,217,2560,-2343
sn35.38,0.2261534712704183,142,217,2560,-2343
sn35.39,0.2261534712704183,142,217,2560,-2343
sn35.40,0.2261534712704183,142,217,2560,-2343
sn35.41,0.2261534712704183,142,217,2560,-2343
sn35.42,0.2261534712704183,142,217,2560,-2343
sn35.43,0.12900532618143057,187,329,2716,-2387
sn35.44,0.12900532618143057,187,329,2716,-2387
sn35.45,0.12900532618143057,187,329,2716,-2387
sn35.46,0.12900532618143057,187,329,2716,-2387
sn35.47,0.12900532618143057,187,329,2716,-2387
sn35.48,0.12900532618143057,187,329,2716,-2387
sn35.49,0.12900532618143057,187,329,2716,-2387
sn35.50,0.12900532618143057,187,329,2716,-2387
sn35.51,0.12900532618143057,187,329,2716,-2387
sn35.52,0.14063835313111728,160,215,2759,-2544
sn35.53,0.26973391640590094,120,210,2411,-2201
sn35.54,0.12981479063185475,79,152,2985,-2833
sn35.55,0.11619950575603166,85,151,3062,-2911
sn35.56,4.376269051586945e-05,12,51,3509,-3458
sn35.57,4.376269049366499e-05,13,47,3527,-3480
sn35.58,4.376269049366499e-05,11,13,3427,-3414
sn35.59,0.07494652589834505,63,107,3254,-3147
sn35.60,4.376269051586945e-05,108,186,2973,-2787
sn35.61,0.12561083209425838,99,181,2640,-2459
sn35.62,0.43578130663119996,231,320,2033,-1713
sn35.63,0.3500199788640357,267,53,2194,-2141
sn35.64,0.26497224902379823,230,59,2498,-2439
sn35.65,0.12520993909743705,186,249,2895,-2646
sn35.66,4.376269051586945e-05,16,38,3636,-3598
sn35.67,4.376269051586945e-05,16,178,3110,-2932
sn35.68,0.03914041582033789,95,252,2860,-2608
sn35.69,0.2588665694634118,219,133,2431,-2298
sn35.70,0.28109143437868855,352,114,2395,-2281
sn35.71,0.11736508939321766,136,211,2884,-2673
sn35.72,0.10244663390035491,153,216,2930,-2714
sn35.73,0.394915348083269,149,278,2108,-1830
sn35.74,0.5546906415126118,307,267,1847,-1580
sn35.75,0.6894231299100051,295,363,1593,-1230
sn35.76,0.33977617930163184,113,312,2212,-1900
sn35.77,4.376269051586945e-05,74,290,2892,-2602
sn35.78,0.20396016046082543,64,242,2649,-2407
sn35.79,0.2622218422141387,156,190,2547,-2357
sn35.80,0.36043535006926586,154,230,2172,-1942
sn35.81,0.3855971553587745,209,250,2123,-1873
sn35.82,0.22258551483196332,89,121,2617,-2496
sn35.83,0.1619466099255895,136,19,2709,-2690
sn35.84,0.25903338425128375,106,148,2463,-2315
sn35.85,0.09378153223102981,101,65,3257,-3192
sn35.86,0.342921959623399,201,379,2206,-1827
sn35.87,0.4329727669483363,743,399,1987,-1588
sn35.88,0.21473621885010896,580,37,2858,-2821
sn35.89,0.6005710755195626,216,377,1714,-1337
sn35.90,0.06455008632737513,251,87,3500,-3413
sn35.91,0.07265032660710435,248,79,3225,-3146
sn35.92,0.2442709518235331,58,68,2604,-2536
sn35.93,0.20781119841624118,349,162,2598,-2436
sn35.94,0.15445267948475117,226,17,3187,-3170
sn35.95,0.47086950623347334,778,88,1949,-1861
sn35.96,0.2368277183314449,227,82,2650,-2568
sn35.97,0.09150156601902548,212,101,2878,-2777
sn35.98,4.376269051586945e-05,145,67,3141,-3074
sn35.99,4.376269049366499e-05,76,353,2978,-2625
sn35.100,4.376269049366499e-05,52,332,3241,-2909
sn35.101,0.11686298307422849,299,174,2943,-2769
sn35.102,4.376269049366499e-05,97,148,3288,-3140
sn35.103,0.19538255067079735,220,44,2909,-2865
sn35.104,0.14882841283094805,73,101,2947,-2846
sn35.105,0.1859304248462479,151,313,2645,-2332
sn35.106,0.02469664011817141,152,213,2726,-2513
sn35.107,0.1255589289758996,161,234,2565,-2331
sn35.108,0.11286235395771005,169,167,2922,-2755
sn35.109,0.12737927102144386,50,194,2621,-2427
sn35.110,0.159455993215607,50,202,2556,-2354
sn35.111,4.376269049366499e-05,46,42,4157,-4115
sn35.112,4.376269049366499e-05,48,44,3950,-3906
sn35.113,0.3833958020680317,202,234,2119,-1885
sn35.114,4.376269051586945e-05,202,42,3397,-3355
sn35.115,4.376269053807391e-05,162,46,3106,-3060
sn35.116,0.3708817726130187,779,168,2134,-1966
sn35.117,0.2734559096733591,868,52,2468,-2416
sn35.118,0.22008910479922594,226,60,2486,-2426
sn35.119,0.27864022496604246,161,94,2344,-2250
sn35.120,0.539408242435635,270,166,1812,-1646
sn35.121,0.38830228404733713,447,295,2087,-1792
sn35.122,4.376269053807391e-05,67,201,2749,-2548
sn35.123,0.3079635521515467,82,183,2256,-2073
sn35.124,0.22107916507076997,228,120,2438,-2318
sn35.125,0.3036760505924718,67,457,2240,-1783
sn35.126,0.3225523681488651,65,494,2216,-1722
sn35.127,0.4340307472586291,517,113,1990,-1877
sn35.128,0.5474747332664176,68,475,1914,-1439
sn35.129,0.1828333697323048,176,248,2581,-2333
sn35.130,0.21563910422170984,177,217,2456,-2239
sn35.131,0.21069401711983904,228,119,2489,-2370
sn35.132,0.6328258185513524,583,152,1401,-1249
sn35.133,0.27969641058029904,491,47,2387,-2340
sn35.134,0.23862240839696014,169,31,2631,-2600
sn35.135,0.07541519316716094,155,104,2834,-2730
sn35.136,0.44654194288182847,173,119,1974,-1855
sn35.137,0.04320950989804562,79,131,2829,-2698
sn35.138,0.14936971732273374,141,100,3072,-2972
sn35.139,4.376269051586945e-05,71,116,3352,-3236
sn35.140,4.376269049366499e-05,90,126,2947,-2821
sn35.141,4.376269049366499e-05,63,92,2886,-2794
sn35.142,4.376269051586945e-05,63,116,3149,-3033
sn35.143,4.376269049366499e-05,49,131,3007,-2876
sn35.144,4.376269051586945e-05,49,113,2973,-2860
sn35.145,0.12656850952419418,85,165,2615,-2450
sn35.146,0.3101129640797451,140,192,2319,-2127
sn35.147,0.09857403520741048,106,148,2886,-2738
sn35.148,0.1207511996332622,83,188,2788,-2600
sn35.149,0.0956186508298984,78,118,2975,-2857
sn35.150,0.28624184584160606,139,395,2311,-1916
sn35.151,0.14401591717849715,305,49,2819,-2770
sn35.152,0.16403759028553733,150,299,2575,-2276
sn35.153,0.1981697511433067,449,116,2520,-2404
sn35.154,0.2186414897086264,76,151,2421,-2270
sn35.155,0.4141224431176038,130,122,1990,-1868
sn35.156,4.376269051586945e-05,67,64,3195,-3131
sn35.157,4.376269049366499e-05,48,60,3093,-3033
sn35.158,4.376269051586945e-05,88,109,3096,-2987
sn35.159,4.376269049366499e-05,60,109,2862,-2753
sn35.160,0.10524562465161758,99,197,2952,-2755
sn35.161,0.12053912150609136,90,203,2870,-2667
sn35.162,0.21563416720500328,180,241,2650,-2409
sn35.163,0.09988652672243692,129,251,2949,-2698
sn35.164,0.14992863471390283,111,206,2941,-2735
sn35.165,0.17297832631151255,77,144,2725,-2581
sn35.166,0.09689968094046542,70,106,3393,-3287
sn35.167,0.12453590642957924,108,118,3152,-3034
sn35.168,4.376269051586945e-05,42,216,3407,-3191
sn35.169,4.376269049366499e-05,42,214,3384,-3170
sn35.170,4.376269051586945e-05,42,216,3442,-3226
sn35.171,4.376269049366499e-05,54,167,3426,-3259
sn35.172,4.376269049366499e-05,54,167,3426,-3259
sn35.173,4.376269049366499e-05,54,167,3426,-3259
sn35.174,4.376269049366499e-05,63,156,3482,-3326
sn35.175,4.376269049366499e-05,63,156,3482,-3326
sn35.176,4.376269049366499e-05,63,156,3482,-3326
sn35.177,4.376269051586945e-05,86,148,3522,-3374
sn35.178,4.376269051586945e-05,86,148,3522,-3374
sn35.179,4.376269051586945e-05,86,148,3522,-3374
sn35.180,4.376269049366499e-05,54,158,3300,-3142
sn35.181,4.376269049366499e-05,54,158,3300,-3142
sn35.182,4.376269049366499e-05,54,158,3300,-3142
sn35.183,4.376269053807391e-05,55,169,3314,-3145
sn35.184,4.376269053807391e-05,55,169,3314,-3145
sn35.185,4.376269053807391e-05,55,169,3314,-3145
sn35.186,4.376269051586945e-05,50,188,3556,-3368
sn35.187,4.376269049366499e-05,24,198,3869,-3671
sn35.188,4.376269049366499e-05,24,193,3876,-3683
sn35.189,4.376269049366499e-05,31,138,3764,-3626
sn35.190,4.376269049366499e-05,31,138,3764,-3626
sn35.191,4.376269049366499e-05,31,138,3764,-3626
sn35.192,4.376269051586945e-05,27,115,3957,-3842
sn35.193,4.376269051586945e-05,27,115,3957,-3842
sn35.194,4.376269051586945e-05,27,115,3957,-3842
sn35.195,4.376269051586945e-05,27,124,3680,-3556
sn35.196,4.376269051586945e-05,27,124,3680,-3556
sn35.197,4.376269051586945e-05,27,124,3680,-3556
sn35.198,4.376269051586945e-05,27,104,3632,-3528
sn35.199,4.376269051586945e-05,27,104,3632,-3528
sn35.200,4.376269051586945e-05,27,104,3632,-3528
sn35.201,4.376269051586945e-05,27,112,3689,-3577
sn35.202,4.376269051586945e-05,27,112,3689,-3577
sn35.203,4.376269051586945e-05,27,112,3689,-3577
sn35.204,4.376269051586945e-05,78,231,3489,-3258
sn35.205,4.376269051586945e-05,79,231,3492,-3261
sn35.206,4.376269049366499e-05,78,230,3495,-3265
sn35.207,4.376269049366499e-05,57,214,3465,-3251
sn35.208,4.376269049366499e-05,57,214,3465,-3251
sn35.209,4.376269049366499e-05,57,214,3465,-3251
sn35.210,4.376269049366499e-05,51,182,3609,-3427
sn35.211,4.376269049366499e-05,51,182,3609,-3427
sn35.212,4.376269049366499e-05,51,182,3609,-3427
sn35.213,4.376269049366499e-05,63,224,3314,-3090
sn35.214,4.376269049366499e-05,63,224,3314,-3090
sn35.215,4.376269049366499e-05,63,224,3314,-3090
sn35.216,4.376269049366499e-05,57,191,3303,-3112
sn35.217,4.376269049366499e-05,57,191,3303,-3112
sn35.218,4.376269049366499e-05,57,191,3303,-3112
sn35.219,4.376269049366499e-05,51,186,3427,-3241
sn35.220,4.376269049366499e-05,51,186,3427,-3241
sn35.221,4.376269049366499e-05,51,186,3427,-3241
sn35.222,4.376269049366499e-05,21,215,3865,-3650
sn35.223,4.376269049366499e-05,21,212,3722,-3510
sn35.224,4.376269049366499e-05,21,154,3945,-3791
sn35.225,4.376269049366499e-05,21,191,3603,-3412
sn35.226,4.376269049366499e-05,21,168,3559,-3391
sn35.227,4.376269051586945e-05,34,96,3367,-3271
sn35.228,4.376269051586945e-05,119,6,3328,-3322
sn35.229,4.376269051586945e-05,120,43,3107,-3064
sn35.230,0.11731894235544882,181,43,3034,-2991
sn35.231,0.12768238334976978,725,224,2737,-2513
sn35.232,0.22733662612979266,561,151,2520,-2369
sn35.233,0.24378974695529187,216,87,2539,-2452
sn35.234,0.550826828995854,308,368,1840,-1472
sn35.235,0.2481129436240126,499,197,2398,-2201
sn35.236,4.376269053807391e-05,99,220,2940,-2720
sn35.237,0.1263635892208237,109,198,2674,-2476
sn35.238,0.28921882348422745,504,60,2399,-2339
sn35.239,0.6467923384243512,321,121,1608,-1487
sn35.240,0.24041186124541536,213,36,2697,-2661
sn35.241,0.33959566527170804,379,39,2228,-2189
sn35.242,0.18086591300854327,72,15,2751,-2736
sn35.243,0.4794591973335427,912,132,1784,-1652
sn35.244,0.7079944263238547,659,183,1263,-1080
sn35.245,0.5061603798601766,643,201,1878,-1677
sn35.246,0.23860802824586802,503,27,2577,-2550
sn35.247,0.3215958465349056,496,16,2305,-2289
sn35.248,0.1391571980470241,473,7,3317,-3310
sn36.1,4.376269051586945e-05,34,199,3344,-3145
sn36.2,4.376269051586945e-05,40,254,2907,-2653
sn36.3,0.42836761604949647,102,289,2017,-1728
sn36.4,0.024485108633021113,126,29,3022,-2993
sn36.5,0.2751573997583856,83,184,2411,-2227
sn36.6,0.27929275439979584,446,98,2587,-2489
sn36.7,0.6622539982080289,517,290,1675,-1385
sn36.8,0.7372593067760169,292,284,1383,-1099
sn36.9,4.376269051586945e-05,30,182,3685,-3503
sn36.10,0.1166264344731438,140,259,2764,-2505
sn36.11,0.364500518978339,292,258,2167,-1909
sn36.12,0.12604853005153682,106,40,2985,-2945
sn36.13,4.376269051586945e-05,32,135,3109,-2974
sn36.14,4.376269051586945e-05,81,92,3513,-3421
sn36.15,0.564898097622879,212,279,1720,-1441
sn36.16,0.6245190792156796,102,349,1794,-1445
sn36.17,0.644973279546246,190,262,1661,-1399
sn36.18,0.604442598994126,67,309,1843,-1534
sn36.19,0.4651186610104885,902,254,1843,-1589
sn36.20,0.22923606124791718,159,104,2518,-2414
sn36.21,0.3327911212054113,244,63,2276,-2213
sn36.22,0.15289787979322345,168,272,2696,-2424
sn36.23,0.6774056803279693,95,394,1698,-1304
sn36.24,0.36062065293707146,59,286,2181,-1895
sn36.25,4.376269049366499e-05,109,48,3277,-3229
sn36.26,0.5465908658307539,69,305,1918,-1613
sn36.27,0.07075517008339194,105,288,2697,-2409
sn36.28,4.376269049366499e-05,42,311,2956,-2645
sn36.29,4.376269051586945e-05,29,132,2894,-2762
sn36.30,4.376269049366499e-05,16,233,3736,-3503
sn36.31,0.4341021968250258,455,148,1987,-1839
sn37.1,4.376269049366499e-05,71,214,3784,-3570
sn37.2,4.376269049366499e-05,71,207,3677,-3470
sn37.3,0.02902318256357006,114,49,3282,-3233
sn37.4,0.1470698099348411,52,469,2527,-2058
sn37.5,0.06661044815685635,96,576,2628,-2052
sn37.6,4.376269051586945e-05,47,571,3312,-2741
sn37.7,4.376269051586945e-05,47,571,3312,-2741
sn37.8,4.376269049366499e-05,46,520,3330,-2810
sn37.9,4.376269051586945e-05,40,277,3431,-3154
sn37.10,4.376269049366499e-05,38,265,3424,-3159
sn37.11,4.376269051586945e-05,38,265,3435,-3170
sn37.12,4.376269051586945e-05,41,279,3420,-3141
sn37.13,4.376269051586945e-05,38,265,3433,-3168
sn37.14,4.376269049366499e-05,63,390,3201,-2811
sn37.15,0.0765484311166853,93,580,2611,-2031
sn37.16,4.376269049366499e-05,44,581,3270,-2689
sn37.17,4.376269049366499e-05,33,539,3300,-2761
sn37.18,4.376269049366499e-05,9,20,4287,-4267
sn37.19,4.376269049366499e-05,9,14,4295,-4281
sn37.20,4.376269051586945e-05,9,50,4204,-4154
sn37.21,4.376269049366499e-05,9,50,4248,-4198
sn37.22,4.376269051586945e-05,9,46,4263,-4217
sn37.23,4.376269051586945e-05,26,545,2631,-2086
sn37.24,4.376269051586945e-05,63,553,2956,-2403
sn37.25,4.376269049366499e-05,26,186,3430,-3244
sn37.26,4.376269049366499e-05,27,171,3432,-3261
sn37.27,4.376269049366499e-05,26,182,3438,-3256
sn37.28,4.376269051586945e-05,31,5,3919,-3914
sn37.29,4.376269051586945e-05,153,52,3659,-3607
sn37.30,4.376269049366499e-05,141,54,3689,-3635
sn37.31,4.376269051586945e-05,48,419,3322,-2903
sn37.32,4.376269049366499e-05,180,8,3527,-3519
sn37.33,4.376269049366499e-05,39,282,3657,-3375
sn37.34,4.376269056027837e-05,68,61,3379,-3318
sn38.1,0.2441414169580547,113,305,2561,-2256
sn38.2,0.04732942111316252,78,234,3193,-2959
sn38.3,0.08242304901184827,141,234,2811,-2577
sn38.4,4.376269051586945e-05,73,256,3244,-2988
sn38.5,0.04415267024617808,89,259,3146,-2887
sn38.6,0.054726264614490816,92,250,3043,-2793
sn38.7,0.042417064764577184,91,326,3039,-2713
sn38.8,0.07271693315011873,82,311,3013,-2702
sn38.9,0.05885545859121155,84,237,3119,-2882
sn38.10,0.03343949496337206,81,310,3126,-2816
sn38.11,0.06448525594495713,81,247,3099,-2852
sn38.12,0.05863523051989894,82,243,3187,-2944
sn38.13,0.06039811221316693,81,256,3179,-2923
sn38.14,0.07884790409293796,81,281,2895,-2614
sn38.15,0.08834208623949014,88,250,2973,-2723
sn38.16,0.25305871698368954,54,177,2466,-2289
sn39.1,0.35902768132249907,115,299,2177,-1878
sn40.1,0.42420250803412163,157,320,2027,-1707
sn40.2,0.2186826885490989,125,234,2468,-2234
sn40.3,0.26996116961144345,143,253,2345,-2092
sn40.4,0.392544316342347,120,347,2137,-1790
sn40.5,0.180435281795277,103,179,2568,-2389
sn40.6,0.13332068544762432,91,173,2866,-2693
sn40.7,0.1358688956940357,91,167,2838,-2671
sn40.8,0.22155415129947453,85,258,2453,-2195
sn40.9,0.20233164728069575,101,147,2499,-2352
sn40.10,0.22967385214232028,2095,390,2518,-2128
sn40.11,0.06369233422054421,51,35,2951,-2916
sn41.1,0.36229097870037474,393,137,2123,-1986
sn41.2,0.33172284752784886,285,192,2218,-2026
sn41.3,0.6275428212942691,667,190,1738,-1548
sn41.4,0.29281500687126094,372,116,2311,-2195
sn41.5,0.37588740605323245,211,126,2143,-2017
sn41.6,0.398850559537256,454,164,2074,-1910
sn41.7,0.4559141444657522,384,86,1906,-1820
sn41.8,0.41634319729444424,406,135,1927,-1792
sn41.9,0.35973713511430194,350,156,2082,-1926
sn41.10,0.3544770991206869,309,107,2186,-2079
sn42.1,0.15104614054719523,219,53,2845,-2792
sn42.2,0.47459440813419906,372,295,1845,-1550
sn42.3,0.30353365256019504,268,310,2286,-1976
sn42.4,4.376269051586945e-05,15,24,3408,-3384
sn42.5,0.3096977401006784,266,302,2267,-1965
sn42.6,0.26616408862831786,454,401,2402,-2001
sn42.7,0.48312024016661237,464,49,1876,-1827
sn42.8,0.42690375356773114,1123,119,1957,-1838
sn42.9,0.3764502117496349,396,35,2110,-2075
sn42.10,0.13839886865560924,260,50,3235,-3185
sn42.11,0.4744788824577295,476,90,1961,-1871
sn42.12,0.14670527568698688,1614,42,3241,-3199
sn42.13,0.806327517894867,3130,285,1405,-1120
sn43.1,0.25683066579480496,67,202,2426,-2224
sn43.2,4.376269051586945e-05,34,195,2779,-2584
sn43.3,4.376269051586945e-05,16,68,3116,-3048
sn43.4,4.376269051586945e-05,16,96,3225,-3129
sn43.5,4.376269049366499e-05,13,181,2879,-2698
sn43.6,4.376269049366499e-05,13,174,2881,-2707
sn43.7,4.376269049366499e-05,13,173,2883,-2710
sn43.8,4.376269051586945e-05,12,179,3111,-2932
sn43.9,4.376269049366499e-05,13,203,2862,-2659
sn43.10,4.376269051586945e-05,13,203,3052,-2849
sn43.11,4.376269053807391e-05,61,162,2596,-2434
sn43.12,0.35007082543538903,841,358,2199,-1841
sn43.13,4.376269049366499e-05,19,163,3439,-3276
sn43.14,0.03268306831081258,428,259,3627,-3368
sn43.15,0.03268306831081258,428,259,3627,-3368
sn43.16,0.03268306831081258,428,259,3627,-3368
sn43.17,0.03268306831081258,428,259,3627,-3368
sn43.18,0.03268306831081258,428,259,3627,-3368
sn43.19,0.03268306831081258,428,259,3627,-3368
sn43.20,0.03268306831081258,428,259,3627,-3368
sn43.21,0.03268306831081258,428,259,3627,-3368
sn43.22,0.03268306831081258,428,259,3627,-3368
sn43.23,0.03268306831081258,428,259,3627,-3368
sn43.24,0.03268306831081258,428,259,3627,-3368
sn43.25,0.03268306831081258,428,259,3627,-3368
sn43.26,0.03268306831081258,428,259,3627,-3368
sn43.27,0.03268306831081258,428,259,3627,-3368
sn43.28,0.03268306831081258,428,259,3627,-3368
sn43.29,0.03268306831081258,428,259,3627,-3368
sn43.30,0.03268306831081258,428,259,3627,-3368
sn43.31,0.03268306831081258,428,259,3627,-3368
sn43.32,0.03268306831081258,428,259,3627,-3368
sn43.33,0.03268306831081258,428,259,3627,-3368
sn43.34,0.03268306831081258,428,259,3627,-3368
sn43.35,0.03268306831081258,428,259,3627,-3368
sn43.36,0.03268306831081258,428,259,3627,-3368
sn43.37,0.03268306831081258,428,259,3627,-3368
sn43.38,0.03268306831081258,428,259,3627,-3368
sn43.39,0.03268306831081258,428,259,3627,-3368
sn43.40,0.03268306831081258,428,259,3627,-3368
sn43.41,0.03268306831081258,428,259,3627,-3368
sn43.42,0.03268306831081258,428,259,3627,-3368
sn43.43,0.03268306831081258,428,259,3627,-3368
sn43.44,0.28961869512731386,107,142,2342,-2200
sn44.1,0.5444137800427518,1134,475,1792,-1317
sn44.2,0.6637799508340647,778,434,1700,-1266
sn44.3,0.22551605689911103,344,514,2438,-1924
sn44.4,0.13606221624591353,241,488,2660,-2172
sn44.5,0.17822497161776862,144,377,2579,-2202
sn44.6,0.3174718091381479,509,548,2256,-1708
sn44.7,0.2502241015753137,765,574,2432,-1858
sn44.8,0.3071301350512812,625,500,2256,-1756
sn44.9,0.15597593131091436,337,94,3033,-2939
sn44.10,0.15816090726519239,148,63,2646,-2583
sn44.11,0.33152315980036207,320,499,2272,-1773
sn45.1,0.1122781695223507,94,34,3250,-3216
sn45.2,0.37899026390657564,175,316,2138,-1822
sn45.3,0.4014193349503481,135,260,2052,-1792
sn45.4,0.27386668675684067,312,138,2457,-2319
sn45.5,0.39860668149613865,175,166,2086,-1920
sn45.6,0.5833862710985738,48,281,1857,-1576
sn45.7,0.3208903298373311,77,87,2248,-2161
sn45.8,0.8284146172611973,288,507,1109,-602
sn45.9,0.2156387035798124,147,140,2565,-2425
sn45.10,0.516304431144099,98,378,1857,-1479
sn45.11,0.2456652891731137,100,81,2587,-2506
sn45.12,0.15582730033181225,114,87,2877,-2790
sn45.13,0.2874789306331227,45,54,2315,-2261
sn45.14,0.18418243412718915,34,156,2623,-2467
sn45.15,0.05525098907714909,28,149,2743,-2594
sn45.16,0.1325862171590586,38,68,2971,-2903
sn45.17,0.018262017443282375,32,49,3134,-3085
sn45.18,0.16512934876693475,94,295,2505,-2210
sn45.19,0.2544263239502964,64,340,2484,-2144
sn45.20,0.4011305196792492,90,344,2004,-1660
sn45.21,4.376269051586945e-05,32,176,2891,-2715
sn45.22,0.3011299406344259,43,319,2347,-2028
sn45.23,0.10984976969181659,34,153,2711,-2558
sn45.24,0.265760653767777,103,43,2342,-2299
sn45.25,0.1779232221851501,45,188,2783,-2595
sn45.26,0.18049464367142498,84,183,2667,-2484
sn45.27,0.11356797124149054,56,33,2852,-2819
sn45.28,0.18859262821153688,38,165,2720,-2555
sn45.29,4.376269051586945e-05,46,282,3153,-2871
sn45.30,0.5186902636347801,127,254,1876,-1622
sn45.31,0.15370064742115108,35,218,2632,-2414
sn45.32,0.2977153260405041,40,234,2410,-2176
sn45.33,4.376269051586945e-05,70,151,3167,-3016
sn45.34,0.4746334988410039,84,144,1765,-1621
sn45.35,0.12591108067130374,36,218,2817,-2599
sn45.36,0.11196908291455365,38,238,2752,-2514
sn45.37,0.11502237821150452,37,162,3064,-2902
sn45.38,0.10131549250671501,37,218,2827,-2609
sn45.39,0.24449820096030805,36,289,2558,-2269
sn45.40,0.3141887819510858,54,262,2336,-2074
sn45.41,0.1826139301265295,91,201,2671,-2470
sn45.42,0.06796635734531709,77,183,3234,-3051
sn45.43,0.06796635734531709,77,183,3234,-3051
sn45.44,0.06796635734531709,77,183,3234,-3051
sn45.45,0.06796635734531709,77,183,3234,-3051
sn45.46,0.06796635734531709,77,183,3234,-3051
sn45.47,0.06796635734531709,77,183,3234,-3051
sn45.48,0.30676283234536417,98,337,2260,-1923
sn45.49,0.19267182055713317,77,243,2826,-2583
sn45.50,4.376269051586945e-05,46,148,3337,-3189
sn45.51,4.376269051586945e-05,46,148,3337,-3189
sn45.52,4.376269051586945e-05,46,148,3337,-3189
sn45.53,4.376269051586945e-05,46,148,3337,-3189
sn45.54,4.376269051586945e-05,46,148,3337,-3189
sn45.55,0.15138385933368692,76,287,2493,-2206
sn45.56,0.05145541734792314,74,213,2948,-2735
sn45.57,4.376269051586945e-05,42,120,3461,-3341
sn45.58,4.376269051586945e-05,42,120,3461,-3341
sn45.59,4.376269051586945e-05,42,120,3461,-3341
sn45.60,4.376269051586945e-05,42,120,3461,-3341
sn45.61,4.376269051586945e-05,42,120,3461,-3341
sn45.62,0.09047907452341963,64,265,2624,-2359
sn45.63,0.15478106907909073,65,230,2927,-2697
sn45.64,4.376269049366499e-05,30,114,3622,-3508
sn45.65,4.376269049366499e-05,30,114,3622,-3508
sn45.66,4.376269049366499e-05,30,114,3622,-3508
sn45.67,4.376269049366499e-05,30,114,3622,-3508
sn45.68,4.376269049366499e-05,30,114,3622,-3508
sn45.69,0.08362226136682249,55,285,2693,-2408
sn45.70,0.1376182822038885,63,204,2938,-2734
sn45.71,4.376269051586945e-05,31,115,3170,-3055
sn45.72,4.376269051586945e-05,31,115,3170,-3055
sn45.73,4.376269051586945e-05,31,115,3170,-3055
sn45.74,4.376269051586945e-05,31,115,3170,-3055
sn45.75,4.376269051586945e-05,31,115,3170,-3055
sn45.76,0.10126505063061675,61,259,2598,-2339
sn45.77,0.23495229593550881,74,276,2650,-2374
sn45.78,4.376269051586945e-05,49,137,3327,-3190
sn45.79,4.376269051586945e-05,49,137,3327,-3190
sn45.80,4.376269051586945e-05,49,137,3327,-3190
sn45.81,4.376269051586945e-05,49,137,3327,-3190
sn45.82,4.376269051586945e-05,49,137,3327,-3190
sn45.83,0.0751662229067529,54,277,2801,-2524
sn45.84,0.11485797070680537,74,239,2920,-2681
sn45.85,4.376269051586945e-05,49,137,3327,-3190
sn45.86,4.376269051586945e-05,49,137,3327,-3190
sn45.87,4.376269051586945e-05,49,137,3327,-3190
sn45.88,4.376269051586945e-05,49,137,3327,-3190
sn45.89,4.376269051586945e-05,49,137,3327,-3190
sn45.90,0.07396961676888747,66,259,2647,-2388
sn45.91,0.10092697067933809,73,280,3221,-2941
sn45.92,4.376269049366499e-05,52,171,3643,-3472
sn45.93,4.376269049366499e-05,52,171,3643,-3472
sn45.94,4.376269049366499e-05,52,171,3643,-3472
sn45.95,4.376269049366499e-05,52,171,3643,-3472
sn45.96,0.05774299268828109,77,275,3348,-3073
sn45.97,0.03792028246103474,69,262,3479,-3217
sn45.98,0.13205813793579768,155,291,2909,-2618
sn45.99,0.13205813793579768,155,291,2909,-2618
sn45.100,0.13205813793579768,155,291,2909,-2618
sn45.101,0.13205813793579768,155,291,2909,-2618
sn45.102,0.13205813793579768,155,291,2909,-2618
sn45.103,0.020194425499453494,70,278,3307,-3029
sn45.104,4.376269049366499e-05,79,173,3355,-3182
sn45.105,4.376269049366499e-05,79,173,3355,-3182
sn45.106,4.376269049366499e-05,79,173,3355,-3182
sn45.107,4.376269049366499e-05,79,173,3355,-3182
sn45.108,4.376269049366499e-05,79,173,3355,-3182
sn45.109,0.02627297341548651,70,264,3289,-3025
sn45.110,0.040488845058384015,134,266,2945,-2679
sn45.111,0.040488845058384015,134,266,2945,-2679
sn45.112,0.040488845058384015,134,266,2945,-2679
sn45.113,0.040488845058384015,134,266,2945,-2679
sn45.114,0.040488845058384015,134,266,2945,-2679
sn45.115,4.376269053807391e-05,70,244,3515,-3271
sn45.116,4.376269049366499e-05,79,173,3355,-3182
sn45.117,4.376269049366499e-05,79,173,3355,-3182
sn45.118,4.376269049366499e-05,79,173,3355,-3182
sn45.119,4.376269049366499e-05,79,173,3355,-3182
sn45.120,4.376269049366499e-05,79,173,3355,-3182
sn45.121,4.376269051586945e-05,70,231,3493,-3262
sn45.122,0.033730795924702406,134,239,3228,-2989
sn45.123,0.033730795924702406,134,239,3228,-2989
sn45.124,0.033730795924702406,134,239,3228,-2989
sn45.125,0.033730795924702406,134,239,3228,-2989
sn45.126,0.033730795924702406,134,239,3228,-2989
sn45.127,4.376269053807391e-05,70,242,3696,-3454
sn45.128,0.018058509037843784,134,247,3322,-3075
sn45.129,0.018058509037843784,134,247,3322,-3075
sn45.130,0.018058509037843784,134,247,3322,-3075
sn45.131,0.018058509037843784,134,247,3322,-3075
sn45.132,0.018058509037843784,134,247,3322,-3075
sn45.133,4.376269051586945e-05,70,226,3673,-3447
sn45.134,0.0779164608285754,153,256,3097,-2841
sn45.135,0.0779164608285754,153,256,3097,-2841
sn45.136,0.0779164608285754,153,256,3097,-2841
sn45.137,0.0779164608285754,153,256,3097,-2841
sn45.138,0.0779164608285754,153,256,3097,-2841
sn45.139,0.22226690834503682,373,281,2510,-2229
sn45.140,0.20993822915678084,87,246,2557,-2311
sn45.141,4.376269051586945e-05,87,270,2658,-2388
sn45.142,4.376269051586945e-05,87,270,2658,-2388
sn45.143,4.376269051586945e-05,87,270,2658,-2388
sn45.144,4.376269051586945e-05,87,270,2658,-2388
sn45.145,4.376269051586945e-05,87,270,2658,-2388
sn45.146,0.2870191286165502,139,318,2348,-2030
sn45.147,0.2870191286165502,139,318,2348,-2030
sn45.148,0.2870191286165502,139,318,2348,-2030
sn45.149,0.08587544637739253,316,270,3167,-2897
sn45.150,0.0443385674737895,101,248,3366,-3118
sn45.151,0.06822603625640244,118,247,3154,-2907
sn45.152,0.11270962853322519,83,263,2941,-2678
sn45.153,0.04687747523961505,80,235,3280,-3045
sn45.154,0.1098121941240926,92,170,2866,-2696
sn45.155,0.018955880361315458,157,135,3477,-3342
sn45.156,0.04573024787932756,83,226,3397,-3171
sn45.157,0.04505326085511019,80,223,3393,-3170
sn45.158,0.0813110025904118,87,185,3047,-2862
sn45.159,0.2800282928439479,237,311,2338,-2027
sn45.160,0.3116536918338797,195,332,2380,-2048
sn45.161,0.10329828128066154,326,384,2948,-2564
sn45.162,0.07581276922643543,66,382,3034,-2652
sn45.163,4.376269049366499e-05,29,221,3287,-3066
sn45.164,4.376269049366499e-05,29,202,3415,-3213
sn45.165,4.376269051586945e-05,30,300,3144,-2844
sn45.166,4.376269051586945e-05,33,157,3482,-3325
sn45.167,4.376269051586945e-05,32,172,3605,-3433
sn45.168,4.376269051586945e-05,33,258,3344,-3086
sn45.169,4.376269051586945e-05,33,333,3416,-3083
sn45.170,0.06470338999269298,69,405,2982,-2577
sn45.171,0.22053326376076932,35,331,2411,-2080
sn45.172,4.376269051586945e-05,30,307,3238,-2931
sn45.173,4.376269049366499e-05,30,207,3390,-3183
sn45.174,4.376269049366499e-05,34,177,3253,-3076
sn45.175,4.376269051586945e-05,32,195,3434,-3239
sn45.176,4.376269051586945e-05,57,261,3232,-2971
sn45.177,4.376269051586945e-05,31,173,3497,-3324
sn45.178,4.376269051586945e-05,32,186,3284,-3098
sn45.179,4.376269049366499e-05,33,240,3443,-3203
sn45.180,0.29485680099594624,172,380,2290,-1910
sn46.1,0.17939116377923003,134,343,2791,-2448
sn46.2,0.31626569556839623,432,218,2361,-2143
sn46.3,0.41145339936967673,512,407,2087,-1680
sn46.4,0.3682184684024037,264,231,2171,-1940
sn46.5,0.562893609409687,84,312,1834,-1522
sn46.6,0.5866837699460392,502,252,1504,-1252
sn46.7,0.08921323891333266,69,356,2893,-2537
sn46.8,0.23099052797461717,134,284,2550,-2266
sn46.9,4.376269051586945e-05,32,215,3040,-2825
sn46.10,4.376269049366499e-05,37,188,3042,-2854
sn46.11,0.19135002013916935,83,290,2658,-2368
sn46.12,0.08982050318351309,65,325,2793,-2468
sn46.13,0.18151173850446956,65,342,2478,-2136
sn46.14,0.26385889074178603,143,162,2410,-2248
sn46.15,0.27898260598329117,144,176,2373,-2197
sn46.16,0.33642809158687115,110,176,2233,-2057
sn46.17,0.3203941620017803,75,176,2262,-2086
sn46.18,0.06895217387221653,56,243,2655,-2412
sn46.19,4.376269049366499e-05,30,189,3140,-2951
sn46.20,4.376269051586945e-05,45,227,2961,-2734
sn46.21,0.34147125434518255,54,278,2208,-1930
sn46.22,4.376269053807391e-05,21,269,2880,-2611
sn46.23,4.376269051586945e-05,94,198,2696,-2498
sn46.24,4.376269049366499e-05,128,173,3127,-2954
sn46.25,0.14299301768028183,28,295,2555,-2260
sn46.26,0.38080079533866495,121,280,2132,-1852
sn46.27,0.2895671842962466,67,397,2335,-1938
sn46.28,0.14163990657685144,111,163,2981,-2818
sn46.29,0.37907611624405924,99,335,2106,-1771
sn46.30,0.4636980744575414,255,207,2016,-1809
sn46.31,0.19082211040830632,59,320,2581,-2261
sn46.32,0.24443714707871322,59,363,2390,-2027
sn46.33,0.10300167918488867,215,24,3184,-3160
sn46.34,4.376269051586945e-05,49,177,3303,-3126
sn46.35,4.376269051586945e-05,74,213,2971,-2758
sn46.36,4.376269049366499e-05,25,216,3243,-3027
sn46.37,4.376269051586945e-05,108,124,3069,-2945
sn46.38,0.18993807458040912,119,143,2657,-2514
sn46.39,0.07345454987062183,177,63,2974,-2911
sn46.40,0.16336429385992446,103,158,2653,-2495
sn46.41,0.12619892249028375,90,283,2943,-2660
sn46.42,4.376269051586945e-05,71,159,3301,-3142
sn46.43,4.376269056027837e-05,25,215,2840,-2625
sn46.44,0.1742703631029352,55,145,2619,-2474
sn46.45,4.376269051586945e-05,38,188,3259,-3071
sn46.46,4.376269051586945e-05,33,134,3292,-3158
sn46.47,4.376269051586945e-05,33,169,3300,-3131
sn46.48,0.08788503655170476,66,319,2812,-2493
sn46.49,0.10033488415501779,57,328,2664,-2336
sn46.50,0.08301292053720655,68,300,2884,-2584
sn46.51,0.24793385373020893,691,219,2525,-2306
sn46.52,0.6123243332375017,643,205,1527,-1322
sn46.53,0.3335472458663835,468,201,2305,-2104
sn46.54,0.6550794507153457,964,303,1564,-1261
sn46.55,0.38700580750663516,1093,242,2064,-1822
sn46.56,0.649579996047378,321,224,1709,-1485
sn46.57,0.1428859936827287,271,194,3041,-2847
sn46.58,4.376269049366499e-05,7,59,4146,-4087
sn46.59,4.376269049366499e-05,6,4,4241,-4237
sn46.60,4.376269049366499e-05,6,33,3753,-3720
sn46.61,4.376269049366499e-05,6,70,3514,-3444
sn46.62,4.376269049366499e-05,7,88,4201,-4113
sn46.63,4.376269049366499e-05,7,86,4203,-4117
sn46.64,4.376269051586945e-05,7,67,4226,-4159
sn46.65,4.376269051586945e-05,7,94,4124,-4030
sn46.66,4.376269051586945e-05,18,24,3787,-3763
sn46.67,4.376269049366499e-05,6,19,4215,-4196
sn46.68,4.376269049366499e-05,6,30,4212,-4182
sn46.69,4.376269049366499e-05,7,20,4230,-4210
sn46.70,4.376269049366499e-05,7,45,3964,-3919
sn46.71,4.376269051586945e-05,6,40,4295,-4255
sn46.72,4.376269049366499e-05,7,10,4332,-4322
sn46.73,4.376269049366499e-05,7,22,4294,-4272
sn46.74,4.376269049366499e-05,6,8,4349,-4341
sn46.75,4.376269049366499e-05,6,18,4350,-4332
sn46.76,0.22050520618579483,182,336,2477,-2141
sn46.77,0.17933915375654141,80,407,2728,-2321
sn46.78,0.17933915375654141,80,407,2728,-2321
sn46.79,0.17933915375654141,80,407,2728,-2321
sn46.80,0.17933915375654141,80,407,2728,-2321
sn46.81,0.17933915375654141,80,407,2728,-2321
sn46.82,0.17933915375654141,80,407,2728,-2321
sn46.83,0.17933915375654141,80,407,2728,-2321
sn46.84,0.17933915375654141,80,407,2728,-2321
sn46.85,0.17933915375654141,80,407,2728,-2321
sn46.86,0.17933915375654141,80,407,2728,-2321
sn46.87,0.17933915375654141,80,407,2728,-2321
sn46.88,0.17933915375654141,80,407,2728,-2321
sn46.89,4.376269051586945e-05,26,231,3368,-3137
sn46.90,4.376269051586945e-05,26,231,3368,-3137
sn46.91,4.376269051586945e-05,26,231,3368,-3137
sn46.92,4.376269051586945e-05,26,231,3368,-3137
sn46.93,4.376269051586945e-05,26,231,3368,-3137
sn46.94,4.376269051586945e-05,26,231,3368,-3137
sn46.95,4.376269051586945e-05,26,231,3368,-3137
sn46.96,4.376269051586945e-05,26,231,3368,-3137
sn46.97,4.376269051586945e-05,26,231,3368,-3137
sn46.98,4.376269051586945e-05,26,231,3368,-3137
sn46.99,4.376269051586945e-05,24,249,2993,-2744
sn46.100,4.376269051586945e-05,24,249,2993,-2744
sn46.101,4.376269051586945e-05,24,249,2993,-2744
sn46.102,4.376269051586945e-05,24,249,2993,-2744
sn46.103,4.376269051586945e-05,24,249,2993,-2744
sn46.104,4.376269051586945e-05,24,249,2993,-2744
sn46.105,4.376269051586945e-05,24,249,2993,-2744
sn46.106,4.376269051586945e-05,24,249,2993,-2744
sn46.107,4.376269051586945e-05,24,249,2993,-2744
sn46.108,4.376269051586945e-05,24,249,2993,-2744
sn46.109,4.376269051586945e-05,24,249,2993,-2744
sn46.110,4.376269051586945e-05,24,249,2993,-2744
sn46.111,4.376269049366499e-05,27,245,3310,-3065
sn46.112,4.376269049366499e-05,27,245,3310,-3065
sn46.113,4.376269049366499e-05,27,245,3310,-3065
sn46.114,4.376269049366499e-05,27,245,3310,-3065
sn46.115,4.376269049366499e-05,27,245,3310,-3065
sn46.116,4.376269049366499e-05,27,245,3310,-3065
sn46.117,4.376269049366499e-05,27,245,3310,-3065
sn46.118,4.376269049366499e-05,27,245,3310,-3065
sn46.119,4.376269049366499e-05,27,245,3310,-3065
sn46.120,4.376269049366499e-05,27,245,3310,-3065
sn46.121,4.376269049366499e-05,10,140,3621,-3481
sn46.122,4.376269049366499e-05,10,140,3621,-3481
sn46.123,4.376269049366499e-05,10,140,3621,-3481
sn46.124,4.376269049366499e-05,10,140,3621,-3481
sn46.125,4.376269049366499e-05,10,140,3621,-3481
sn46.126,4.376269049366499e-05,10,140,3621,-3481
sn46.127,4.376269049366499e-05,10,140,3621,-3481
sn46.128,4.376269049366499e-05,10,140,3621,-3481
sn46.129,4.376269049366499e-05,10,140,3621,-3481
sn46.130,0.38468950661558754,80,437,2123,-1686
sn46.131,4.376269049366499e-05,19,258,3135,-2877
sn46.132,4.376269049366499e-05,19,258,3135,-2877
sn46.133,4.376269049366499e-05,19,258,3135,-2877
sn46.134,4.376269049366499e-05,19,258,3135,-2877
sn46.135,4.376269049366499e-05,19,258,3135,-2877
sn46.136,4.376269049366499e-05,19,258,3135,-2877
sn46.137,4.376269049366499e-05,19,258,3135,-2877
sn46.138,4.376269049366499e-05,19,258,3135,-2877
sn46.139,4.376269049366499e-05,19,258,3135,-2877
sn46.140,4.376269049366499e-05,19,258,3135,-2877
sn46.141,4.376269049366499e-05,19,258,3135,-2877
sn46.142,4.376269049366499e-05,19,258,3135,-2877
sn46.143,4.376269049366499e-05,16,118,3973,-3855
sn46.144,4.376269049366499e-05,16,118,3973,-3855
sn46.145,4.376269049366499e-05,16,118,3973,-3855
sn46.146,4.376269049366499e-05,16,118,3973,-3855
sn46.147,4.376269049366499e-05,16,118,3973,-3855
sn46.148,4.376269049366499e-05,16,118,3973,-3855
sn46.149,4.376269049366499e-05,16,118,3973,-3855
sn46.150,4.376269049366499e-05,16,118,3973,-3855
sn46.151,4.376269049366499e-05,16,118,3973,-3855
sn46.152,4.376269049366499e-05,16,118,3973,-3855
sn46.153,4.376269049366499e-05,19,208,3417,-3209
sn46.154,4.376269049366499e-05,19,208,3417,-3209
sn46.155,4.376269049366499e-05,19,208,3417,-3209
sn46.156,4.376269049366499e-05,19,208,3417,-3209
sn46.157,4.376269049366499e-05,19,208,3417,-3209
sn46.158,4.376269049366499e-05,19,208,3417,-3209
sn46.159,4.376269049366499e-05,19,208,3417,-3209
sn46.160,4.376269049366499e-05,19,208,3417,-3209
sn46.161,4.376269049366499e-05,19,208,3417,-3209
sn46.162,4.376269049366499e-05,19,208,3417,-3209
sn46.163,4.376269049366499e-05,19,208,3417,-3209
sn46.164,4.376269049366499e-05,19,208,3417,-3209
sn46.165,4.376269049366499e-05,16,101,4131,-4030
sn46.166,4.376269049366499e-05,16,101,4131,-4030
sn46.167,4.376269049366499e-05,16,101,4131,-4030
sn46.168,4.376269049366499e-05,16,101,4131,-4030
sn46.169,4.376269049366499e-05,16,101,4131,-4030
sn46.170,4.376269049366499e-05,16,101,4131,-4030
sn46.171,4.376269049366499e-05,16,101,4131,-4030
sn46.172,4.376269049366499e-05,16,101,4131,-4030
sn46.173,4.376269049366499e-05,16,101,4131,-4030
sn46.174,4.376269049366499e-05,16,101,4131,-4030
sn46.175,4.376269051586945e-05,20,264,2695,-2431
sn46.176,4.376269051586945e-05,20,264,2695,-2431
sn46.177,4.376269051586945e-05,20,264,2695,-2431
sn46.178,4.376269051586945e-05,20,264,2695,-2431
sn46.179,4.376269051586945e-05,20,264,2695,-2431
sn46.180,4.376269051586945e-05,20,264,2695,-2431
sn46.181,4.376269051586945e-05,20,264,2695,-2431
sn46.182,4.376269051586945e-05,20,264,2695,-2431
sn46.183,4.376269051586945e-05,20,264,2695,-2431
sn46.184,4.376269051586945e-05,20,264,2695,-2431
sn47.1,0.5774151746652523,100,228,1775,-1547
sn47.2,0.2650891015069323,122,134,2490,-2356
sn47.3,0.6388320788383028,293,232,1566,-1334
sn47.4,0.17949256857827667,216,18,2961,-2943
sn47.5,0.28067054478944087,100,234,2471,-2237
sn47.6,0.3222377566998169,269,127,2277,-2150
sn47.7,0.427124326046191,269,134,1945,-1811
sn47.8,0.26831209471527284,490,99,2607,-2508
sn47.9,0.5909691611545531,362,202,1520,-1318
sn47.10,0.465765075592417,557,272,1885,-1613
sn47.11,0.37628857961153894,103,142,2131,-1989
sn47.12,0.5380310466030158,429,131,1824,-1693
sn47.13,0.5237988918526781,365,248,1798,-1550
sn47.14,0.4745844568007085,249,142,1969,-1827
sn47.15,0.65824089914861,185,208,1592,-1384
sn47.16,0.6175077228458781,174,198,1637,-1439
sn47.17,0.1747595690847703,55,224,2675,-2451
sn47.18,0.6065777487918256,211,253,1669,-1416
sn47.19,0.11252549617959406,182,37,3091,-3054
sn47.20,0.2132540065757027,151,39,2658,-2619
sn47.21,0.2596187737365474,151,219,2513,-2294
sn47.22,0.2924699835674227,160,297,2318,-2021
sn47.23,0.6091881903104168,164,404,1847,-1443
sn47.24,0.3734796561854381,40,241,2153,-1912
sn47.25,0.38909760405274607,161,269,2079,-1810
sn47.26,0.4683955153195196,104,343,1960,-1617
sn47.27,0.432105933111937,67,284,2017,-1733
sn47.28,0.3099783207529683,73,306,2267,-1961
sn47.29,0.42747969309027134,276,231,2061,-1830
sn47.30,0.2751426137055146,110,173,2338,-2165
sn47.31,0.07094902935735892,178,40,3361,-3321
sn47.32,0.16127306226403348,58,305,2742,-2437
sn47.33,0.2541122885707958,80,299,2415,-2116
sn47.34,0.16394791901388484,50,226,2719,-2493
sn47.35,0.2632062730130835,95,135,2613,-2478
sn47.36,0.3698797031307155,57,300,2132,-1832
sn47.37,0.1912545166579127,97,209,2717,-2508
sn47.38,0.3194569663432345,89,144,2308,-2164
sn47.39,0.20226493420396618,47,249,2584,-2335
sn47.40,0.64103666850992,132,301,1499,-1198
sn47.41,0.2235322501724868,51,164,2499,-2335
sn47.42,0.030287976473775124,37,119,2693,-2574
sn47.43,0.5845894300120502,218,246,1642,-1396
sn47.44,0.153671005135525,56,192,2658,-2466
sn47.45,0.17525192662997124,59,295,2720,-2425
sn47.46,0.7541545962525875,190,282,1443,-1161
sn47.47,0.3176037927533626,147,162,2285,-2123
sn47.48,0.2286381431206186,80,150,2438,-2288
sn47.49,0.27620501497194194,65,394,2445,-2051
sn47.50,0.2934535724964604,71,326,2316,-1990
sn47.51,0.24576486034952882,91,377,2462,-2085
sn47.52,0.24576486034952882,91,377,2462,-2085
sn47.53,0.24576486034952882,91,377,2462,-2085
sn47.54,0.24576486034952882,91,377,2462,-2085
sn47.55,0.24576486034952882,91,377,2462,-2085
sn47.56,0.24576486034952882,91,377,2462,-2085
sn47.57,0.24576486034952882,91,377,2462,-2085
sn47.58,0.24576486034952882,91,377,2462,-2085
sn47.59,0.24576486034952882,91,377,2462,-2085
sn47.60,0.24576486034952882,91,377,2462,-2085
sn47.61,0.24576486034952882,91,377,2462,-2085
sn47.62,0.24576486034952882,91,377,2462,-2085
sn47.63,4.376269049366499e-05,23,123,3800,-3677
sn47.64,4.376269049366499e-05,23,123,3800,-3677
sn47.65,4.376269049366499e-05,23,123,3800,-3677
sn47.66,4.376269049366499e-05,23,123,3800,-3677
sn47.67,4.376269049366499e-05,23,123,3800,-3677
sn47.68,4.376269049366499e-05,23,123,3800,-3677
sn47.69,4.376269049366499e-05,23,123,3800,-3677
sn47.70,4.376269049366499e-05,23,123,3800,-3677
sn47.71,4.376269049366499e-05,23,123,3800,-3677
sn47.72,4.376269049366499e-05,23,123,3800,-3677
sn47.73,4.376269049366499e-05,21,139,3335,-3196
sn47.74,4.376269049366499e-05,21,139,3335,-3196
sn47.75,4.376269049366499e-05,21,139,3335,-3196
sn47.76,4.376269049366499e-05,21,139,3335,-3196
sn47.77,4.376269049366499e-05,21,139,3335,-3196
sn47.78,4.376269049366499e-05,21,139,3335,-3196
sn47.79,4.376269049366499e-05,21,139,3335,-3196
sn47.80,4.376269049366499e-05,21,139,3335,-3196
sn47.81,4.376269049366499e-05,21,139,3335,-3196
sn47.82,4.376269049366499e-05,21,139,3335,-3196
sn47.83,4.376269049366499e-05,21,139,3335,-3196
sn47.84,4.376269049366499e-05,21,139,3335,-3196
sn47.85,4.376269049366499e-05,24,149,3552,-3403
sn47.86,4.376269049366499e-05,24,149,3552,-3403
sn47.87,4.376269049366499e-05,24,149,3552,-3403
sn47.88,4.376269049366499e-05,24,149,3552,-3403
sn47.89,4.376269049366499e-05,24,149,3552,-3403
sn47.90,4.376269049366499e-05,24,149,3552,-3403
sn47.91,4.376269049366499e-05,24,149,3552,-3403
sn47.92,4.376269049366499e-05,24,149,3552,-3403
sn47.93,4.376269049366499e-05,24,149,3552,-3403
sn47.94,4.376269049366499e-05,24,149,3552,-3403
sn47.95,0.4704933589669613,86,304,1990,-1686
sn47.96,0.4704933589669613,86,304,1990,-1686
sn47.97,0.4704933589669613,86,304,1990,-1686
sn47.98,0.4704933589669613,86,304,1990,-1686
sn47.99,0.4704933589669613,86,304,1990,-1686
sn47.100,0.4704933589669613,86,304,1990,-1686
sn47.101,0.4704933589669613,86,304,1990,-1686
sn47.102,0.4704933589669613,86,304,1990,-1686
sn47.103,0.4704933589669613,86,304,1990,-1686
sn47.104,0.4704933589669613,86,304,1990,-1686
sn48.1,0.0849902357649146,19,205,2760,-2555
sn48.2,4.376269051586945e-05,29,353,2599,-2246
sn48.3,4.376269051586945e-05,31,350,2603,-2253
sn48.4,4.376269051586945e-05,35,187,2686,-2499
sn48.5,4.376269049366499e-05,37,176,2780,-2604
sn48.6,0.11496929652448085,99,231,2634,-2403
sn48.7,0.03357424087353511,141,84,3131,-3047
sn48.8,4.376269049366499e-05,59,99,3652,-3553
sn48.9,0.6354875804420956,112,325,1672,-1347
sn48.10,0.9790700360515769,289,595,1129,-534
sn48.11,0.5663022979891075,103,337,1852,-1515
sn48.12,4.376269051586945e-05,42,90,3588,-3498
sn48.13,4.376269049366499e-05,50,69,3568,-3499
sn48.14,4.376269051586945e-05,56,78,3572,-3494
sn48.15,4.376269051586945e-05,59,98,3145,-3047
sn48.16,4.376269051586945e-05,68,94,3081,-2987
sn48.17,4.376269051586945e-05,73,97,3113,-3016
sn48.18,4.376269051586945e-05,69,93,3348,-3255
sn48.19,0.17688453336679455,57,106,2535,-2429
sn48.20,4.376269049366499e-05,43,315,2900,-2585
sn48.21,4.376269049366499e-05,76,147,3020,-2873
sn48.22,4.376269049366499e-05,12,48,3988,-3940
sn48.23,4.376269049366499e-05,12,29,4009,-3980
sn48.24,4.376269051586945e-05,67,59,3235,-3176
sn48.25,4.376269049366499e-05,15,146,3790,-3644
sn48.26,4.376269051586945e-05,31,244,2583,-2339
sn48.27,4.376269053807391e-05,38,93,2840,-2747
sn48.28,4.376269049366499e-05,77,104,3070,-2966
sn48.29,0.10727865277588844,103,171,2683,-2512
sn48.30,0.050877556877559904,131,73,3101,-3028
sn48.31,4.376269049366499e-05,13,85,3845,-3760
sn48.32,4.376269049366499e-05,31,257,2677,-2420
sn48.33,4.376269051586945e-05,37,124,2858,-2734
sn48.34,0.09297766880334013,101,195,2689,-2494
sn48.35,0.05175357487179344,148,66,3300,-3234
sn48.36,4.376269051586945e-05,93,174,3012,-2838
sn48.37,0.17930343361580725,120,186,2707,-2521
sn48.38,0.2824071034566611,131,184,2417,-2233
sn48.39,0.04052200704569575,242,105,3224,-3119
sn48.40,0.2564444788683451,437,112,2451,-2339
sn48.41,0.21707748059731635,128,18,2494,-2476
sn48.42,0.4198830696159783,226,135,1989,-1854
sn48.43,0.2685415482512443,293,157,2420,-2263
sn48.44,0.04003887653118987,189,80,3307,-3227
sn48.45,0.16129936001063605,99,102,2898,-2796
sn48.46,0.12334428193818692,89,133,2965,-2832
sn48.47,0.08534289511665794,72,140,3152,-3012
sn48.48,0.08237438780158701,73,131,3177,-3046
sn48.49,0.1412364381718989,148,63,3025,-2962
sn48.50,0.5310867321276946,383,87,1643,-1556
sn48.51,0.20765982763535362,99,161,2593,-2432
sn48.52,0.09609308655786908,145,52,3266,-3214
sn48.53,0.3012290091348957,291,118,2386,-2268
sn48.54,4.376269051586945e-05,91,157,3328,-3171
sn48.55,0.10798729311300992,68,203,2738,-2535
sn48.56,0.04270769561582899,58,106,3115,-3009
sn48.57,0.2984232164645162,192,118,2307,-2189
sn48.58,0.09543931325348698,199,39,3189,-3150
sn48.59,4.376269051586945e-05,32,112,3203,-3091
sn48.60,4.376269051586945e-05,35,88,3461,-3373
sn48.61,4.376269051586945e-05,22,221,2729,-2508
sn48.62,4.376269049366499e-05,21,128,3582,-3454
sn48.63,4.376269049366499e-05,21,125,3738,-3613
sn48.64,4.376269051586945e-05,57,145,3247,-3102
sn48.65,4.376269049366499e-05,31,251,3066,-2815
sn48.66,0.11411050259246824,83,277,2611,-2334
sn48.67,0.10398856172584292,66,187,2761,-2574
sn48.68,0.1783522405998772,68,298,2566,-2268
sn48.69,0.10655429687325135,61,175,2752,-2577
sn48.70,0.2013149961221261,71,201,2513,-2312
sn48.71,0.0974692158115742,78,303,2951,-2648
sn48.72,0.0974692158115742,78,303,2951,-2648
sn48.73,0.0974692158115742,78,303,2951,-2648
sn48.74,0.0974692158115742,78,303,2951,-2648
sn48.75,0.0974692158115742,78,303,2951,-2648
sn48.76,0.0974692158115742,78,303,2951,-2648
sn48.77,0.0974692158115742,78,303,2951,-2648
sn48.78,0.0974692158115742,78,303,2951,-2648
sn48.79,0.0974692158115742,78,303,2951,-2648
sn48.80,0.0974692158115742,78,303,2951,-2648
sn48.81,0.0974692158115742,78,303,2951,-2648
sn48.82,0.0974692158115742,78,303,2951,-2648
sn48.83,4.376269049366499e-05,12,96,3981,-3885
sn48.84,4.376269049366499e-05,12,96,3981,-3885
sn48.85,4.376269049366499e-05,12,96,3981,-3885
sn48.86,4.376269049366499e-05,12,96,3981,-3885
sn48.87,4.376269049366499e-05,12,96,3981,-3885
sn48.88,4.376269049366499e-05,12,96,3981,-3885
sn48.89,4.376269049366499e-05,12,96,3981,-3885
sn48.90,4.376269049366499e-05,12,96,3981,-3885
sn48.91,4.376269049366499e-05,12,96,3981,-3885
sn48.92,4.376269049366499e-05,12,96,3981,-3885
sn48.93,4.376269049366499e-05,15,108,3811,-3703
sn48.94,4.376269049366499e-05,15,108,3811,-3703
sn48.95,4.376269049366499e-05,15,108,3811,-3703
sn48.96,4.376269049366499e-05,15,108,3811,-3703
sn48.97,4.376269049366499e-05,15,108,3811,-3703
sn48.98,4.376269049366499e-05,15,108,3811,-3703
sn48.99,4.376269049366499e-05,15,108,3811,-3703
sn48.100,4.376269049366499e-05,15,108,3811,-3703
sn48.101,4.376269049366499e-05,15,108,3811,-3703
sn48.102,4.376269049366499e-05,15,108,3811,-3703
sn48.103,4.376269049366499e-05,15,108,3811,-3703
sn48.104,4.376269049366499e-05,15,108,3811,-3703
sn48.105,4.376269051586945e-05,16,137,3711,-3574
sn48.106,4.376269051586945e-05,16,137,3711,-3574
sn48.107,4.376269051586945e-05,16,137,3711,-3574
sn48.108,4.376269051586945e-05,16,137,3711,-3574
sn48.109,4.376269051586945e-05,16,137,3711,-3574
sn48.110,4.376269051586945e-05,16,137,3711,-3574
sn48.111,4.376269051586945e-05,16,137,3711,-3574
sn48.112,4.376269051586945e-05,16,137,3711,-3574
sn48.113,4.376269051586945e-05,16,137,3711,-3574
sn48.114,4.376269051586945e-05,16,137,3711,-3574
sn48.115,0.09047102079553504,69,313,2759,-2446
sn48.116,0.09047102079553504,69,313,2759,-2446
sn48.117,0.09047102079553504,69,313,2759,-2446
sn48.118,0.09047102079553504,69,313,2759,-2446
sn48.119,0.09047102079553504,69,313,2759,-2446
sn48.120,0.09047102079553504,69,313,2759,-2446
sn48.121,0.09047102079553504,69,313,2759,-2446
sn48.122,0.09047102079553504,69,313,2759,-2446
sn48.123,0.09047102079553504,69,313,2759,-2446
sn48.124,0.09047102079553504,69,313,2759,-2446
sn48.125,0.07615756214933711,71,283,3072,-2789
sn48.126,0.07615756214933711,71,283,3072,-2789
sn48.127,0.07615756214933711,71,283,3072,-2789
sn48.128,0.07615756214933711,71,283,3072,-2789
sn48.129,0.07615756214933711,71,283,3072,-2789
sn48.130,0.07615756214933711,71,283,3072,-2789
sn48.131,0.07615756214933711,71,283,3072,-2789
sn48.132,0.07615756214933711,71,283,3072,-2789
sn48.133,0.07615756214933711,71,283,3072,-2789
sn48.134,0.07615756214933711,71,283,3072,-2789
sn48.135,0.07615756214933711,71,283,3072,-2789
sn48.136,0.07615756214933711,71,283,3072,-2789
sn49.1,0.21115431899434434,194,309,2734,-2425
sn49.2,0.21115431899434434,194,309,2734,-2425
sn49.3,0.21115431899434434,194,309,2734,-2425
sn49.4,0.21115431899434434,194,309,2734,-2425
sn49.5,0.21115431899434434,194,309,2734,-2425
sn49.6,0.21115431899434434,194,309,2734,-2425
sn49.7,0.21115431899434434,194,309,2734,-2425
sn49.8,0.21115431899434434,194,309,2734,-2425
sn49.9,0.21115431899434434,194,309,2734,-2425
sn49.10,0.21115431899434434,194,309,2734,-2425
sn49.11,0.21115431899434434,194,309,2734,-2425
sn49.12,0.21115431899434434,194,309,2734,-2425
sn49.13,4.376269049366499e-05,13,145,3686,-3541
sn49.14,4.376269049366499e-05,13,145,3686,-3541
sn49.15,4.376269049366499e-05,13,145,3686,-3541
sn49.16,4.376269049366499e-05,13,145,3686,-3541
sn49.17,4.376269049366499e-05,13,145,3686,-3541
sn49.18,4.376269049366499e-05,13,145,3686,-3541
sn49.19,4.376269049366499e-05,13,145,3686,-3541
sn49.20,4.376269049366499e-05,13,145,3686,-3541
sn49.21,4.376269049366499e-05,13,145,3686,-3541
sn49.22,4.376269049366499e-05,13,145,3686,-3541
sn49.23,0.10273374732177043,111,273,2730,-2457
sn49.24,0.10273374732177043,111,273,2730,-2457
sn49.25,0.10273374732177043,111,273,2730,-2457
sn49.26,0.10273374732177043,111,273,2730,-2457
sn49.27,0.10273374732177043,111,273,2730,-2457
sn49.28,0.10273374732177043,111,273,2730,-2457
sn49.29,0.10273374732177043,111,273,2730,-2457
sn49.30,0.10273374732177043,111,273,2730,-2457
sn49.31,0.10273374732177043,111,273,2730,-2457
sn49.32,0.10273374732177043,111,273,2730,-2457
sn49.33,0.10273374732177043,111,273,2730,-2457
sn49.34,0.10273374732177043,111,273,2730,-2457
sn49.35,0.10594121772087295,79,352,2784,-2432
sn49.36,0.10594121772087295,79,352,2784,-2432
sn49.37,0.10594121772087295,79,352,2784,-2432
sn49.38,0.10594121772087295,79,352,2784,-2432
sn49.39,0.10594121772087295,79,352,2784,-2432
sn49.40,0.10594121772087295,79,352,2784,-2432
sn49.41,0.10594121772087295,79,352,2784,-2432
sn49.42,0.10594121772087295,79,352,2784,-2432
sn49.43,0.10594121772087295,79,352,2784,-2432
sn49.44,0.10594121772087295,79,352,2784,-2432
sn49.45,0.2769499115095053,79,277,2389,-2112
sn49.46,0.2769499115095053,79,277,2389,-2112
sn49.47,0.2769499115095053,79,277,2389,-2112
sn49.48,0.2769499115095053,79,277,2389,-2112
sn49.49,0.2769499115095053,79,277,2389,-2112
sn49.50,0.2769499115095053,79,277,2389,-2112
sn49.51,0.2769499115095053,79,277,2389,-2112
sn49.52,0.2769499115095053,79,277,2389,-2112
sn49.53,0.2769499115095053,79,277,2389,-2112
sn49.54,0.2769499115095053,79,277,2389,-2112
sn50.1,0.13670184499474658,98,373,2842,-2469
sn50.2,0.13670184499474658,98,373,2842,-2469
sn50.3,0.13670184499474658,98,373,2842,-2469
sn50.4,0.13670184499474658,98,373,2842,-2469
sn50.5,0.13670184499474658,98,373,2842,-2469
sn50.6,0.13670184499474658,98,373,2842,-2469
sn50.7,0.13670184499474658,98,373,2842,-2469
sn50.8,0.13670184499474658,98,373,2842,-2469
sn50.9,0.13670184499474658,98,373,2842,-2469
sn50.10,0.13670184499474658,98,373,2842,-2469
sn50.11,0.13670184499474658,98,373,2842,-2469
sn50.12,0.13670184499474658,98,373,2842,-2469
sn50.13,4.376269049366499e-05,12,96,3981,-3885
sn50.14,4.376269049366499e-05,12,96,3981,-3885
sn50.15,4.376269049366499e-05,12,96,3981,-3885
sn50.16,4.376269049366499e-05,12,96,3981,-3885
sn50.17,4.376269049366499e-05,12,96,3981,-3885
sn50.18,4.376269049366499e-05,12,96,3981,-3885
sn50.19,4.376269049366499e-05,12,96,3981,-3885
sn50.20,4.376269049366499e-05,12,96,3981,-3885
sn50.21,4.376269049366499e-05,12,96,3981,-3885
sn50.22,4.376269049366499e-05,12,96,3981,-3885
sn50.23,4.376269049366499e-05,15,108,3811,-3703
sn50.24,4.376269049366499e-05,15,108,3811,-3703
sn50.25,4.376269049366499e-05,15,108,3811,-3703
sn50.26,4.376269049366499e-05,15,108,3811,-3703
sn50.27,4.376269049366499e-05,15,108,3811,-3703
sn50.28,4.376269049366499e-05,15,108,3811,-3703
sn50.29,4.376269049366499e-05,15,108,3811,-3703
sn50.30,4.376269049366499e-05,15,108,3811,-3703
sn50.31,4.376269049366499e-05,15,108,3811,-3703
sn50.32,4.376269049366499e-05,15,108,3811,-3703
sn50.33,4.376269049366499e-05,15,108,3811,-3703
sn50.34,4.376269049366499e-05,15,108,3811,-3703
sn50.35,4.376269051586945e-05,16,137,3711,-3574
sn50.36,4.376269051586945e-05,16,137,3711,-3574
sn50.37,4.376269051586945e-05,16,137,3711,-3574
sn50.38,4.376269051586945e-05,16,137,3711,-3574
sn50.39,4.376269051586945e-05,16,137,3711,-3574
sn50.40,4.376269051586945e-05,16,137,3711,-3574
sn50.41,4.376269051586945e-05,16,137,3711,-3574
sn50.42,4.376269051586945e-05,16,137,3711,-3574
sn50.43,4.376269051586945e-05,16,137,3711,-3574
sn50.44,4.376269051586945e-05,16,137,3711,-3574
sn50.45,0.09385296973924984,69,332,2751,-2419
sn50.46,0.09385296973924984,69,332,2751,-2419
sn50.47,0.09385296973924984,69,332,2751,-2419
sn50.48,0.09385296973924984,69,332,2751,-2419
sn50.49,0.09385296973924984,69,332,2751,-2419
sn50.50,0.09385296973924984,69,332,2751,-2419
sn50.51,0.09385296973924984,69,332,2751,-2419
sn50.52,0.09385296973924984,69,332,2751,-2419
sn50.53,0.09385296973924984,69,332,2751,-2419
sn50.54,0.09385296973924984,69,332,2751,-2419
sn50.55,0.1361869429327145,71,328,2765,-2437
sn50.56,0.1361869429327145,71,328,2765,-2437
sn50.57,0.1361869429327145,71,328,2765,-2437
sn50.58,0.1361869429327145,71,328,2765,-2437
sn50.59,0.1361869429327145,71,328,2765,-2437
sn50.60,0.1361869429327145,71,328,2765,-2437
sn50.61,0.1361869429327145,71,328,2765,-2437
sn50.62,0.1361869429327145,71,328,2765,-2437
sn50.63,0.1361869429327145,71,328,2765,-2437
sn50.64,0.1361869429327145,71,328,2765,-2437
sn50.65,0.1361869429327145,71,328,2765,-2437
sn50.66,0.1361869429327145,71,328,2765,-2437
sn51.1,0.0959920145731541,37,283,2546,-2263
sn51.2,0.3672186448737902,69,311,2172,-1861
sn51.3,0.16131120146336553,43,266,2468,-2202
sn51.4,0.13800164422137495,47,304,2516,-2212
sn51.5,0.10812606821171133,123,198,2837,-2639
sn51.6,0.13319842208174837,129,199,2668,-2469
sn51.7,0.32307407468186167,165,307,2374,-2067
sn51.8,0.25225902938801337,38,336,2328,-1992
sn51.9,4.376269051586945e-05,169,103,3007,-2904
sn51.10,0.493444390202713,696,140,1833,-1693
sn51.11,0.6145657806277294,603,277,1674,-1397
sn51.12,0.32564914807460266,195,229,2241,-2012
sn51.13,0.20123774156453056,236,176,2493,-2317
sn51.14,0.49926771140211823,315,164,1793,-1629
sn51.15,0.5393278189550044,323,329,1702,-1373
sn51.16,0.1044302117708229,125,192,2709,-2517
sn51.17,0.2788063490777981,288,175,2390,-2215
sn51.18,0.15606396894221053,54,292,2458,-2166
sn51.19,0.351200663635276,93,227,2196,-1969
sn51.20,0.6959424144834303,699,311,1701,-1390
sn51.21,0.40901384669327356,186,199,2097,-1898
sn51.22,0.2216406923461589,260,97,2590,-2493
sn51.23,0.3097787164697108,44,402,2238,-1836
sn51.24,0.1577222077725926,24,314,2481,-2167
sn51.25,0.316666551933098,43,333,2230,-1897
sn51.26,0.29615010095194183,94,295,2256,-1961
sn51.27,0.5204636667596185,98,145,1836,-1691
sn51.28,0.31242381733529445,89,141,2322,-2181
sn51.29,0.5345070432697385,102,178,1730,-1552
sn51.30,0.47584677182679336,112,170,1869,-1699
sn51.31,0.3397421094094577,193,177,2217,-2040
sn51.32,0.42481639501656954,215,217,2039,-1822
sn51.33,0.25055505867144223,75,334,2499,-2165
sn51.34,0.25055505867144223,75,334,2499,-2165
sn51.35,0.25055505867144223,75,334,2499,-2165
sn51.36,0.25055505867144223,75,334,2499,-2165
sn51.37,0.25055505867144223,75,334,2499,-2165
sn51.38,0.25055505867144223,75,334,2499,-2165
sn51.39,0.25055505867144223,75,334,2499,-2165
sn51.40,0.25055505867144223,75,334,2499,-2165
sn51.41,0.25055505867144223,75,334,2499,-2165
sn51.42,0.25055505867144223,75,334,2499,-2165
sn51.43,0.25055505867144223,75,334,2499,-2165
sn51.44,0.25055505867144223,75,334,2499,-2165
sn51.45,4.376269049366499e-05,13,97,3980,-3883
sn51.46,4.376269049366499e-05,13,97,3980,-3883
sn51.47,4.376269049366499e-05,13,97,3980,-3883
sn51.48,4.376269049366499e-05,13,97,3980,-3883
sn51.49,4.376269049366499e-05,13,97,3980,-3883
sn51.50,4.376269049366499e-05,13,97,3980,-3883
sn51.51,4.376269049366499e-05,13,97,3980,-3883
sn51.52,4.376269049366499e-05,13,97,3980,-3883
sn51.53,4.376269049366499e-05,13,97,3980,-3883
sn51.54,4.376269049366499e-05,13,97,3980,-3883
sn51.55,4.376269049366499e-05,15,108,3811,-3703
sn51.56,4.376269049366499e-05,15,108,3811,-3703
sn51.57,4.376269049366499e-05,15,108,3811,-3703
sn51.58,4.376269049366499e-05,15,108,3811,-3703
sn51.59,4.376269049366499e-05,15,108,3811,-3703
sn51.60,4.376269049366499e-05,15,108,3811,-3703
sn51.61,4.376269049366499e-05,15,108,3811,-3703
sn51.62,4.376269049366499e-05,15,108,3811,-3703
sn51.63,4.376269049366499e-05,15,108,3811,-3703
sn51.64,4.376269049366499e-05,15,108,3811,-3703
sn51.65,4.376269049366499e-05,15,108,3811,-3703
sn51.66,4.376269049366499e-05,15,108,3811,-3703
sn51.67,4.376269051586945e-05,16,137,3711,-3574
sn51.68,4.376269051586945e-05,16,137,3711,-3574
sn51.69,4.376269051586945e-05,16,137,3711,-3574
sn51.70,4.376269051586945e-05,16,137,3711,-3574
sn51.71,4.376269051586945e-05,16,137,3711,-3574
sn51.72,4.376269051586945e-05,16,137,3711,-3574
sn51.73,4.376269051586945e-05,16,137,3711,-3574
sn51.74,4.376269051586945e-05,16,137,3711,-3574
sn51.75,4.376269051586945e-05,16,137,3711,-3574
sn51.76,4.376269051586945e-05,16,137,3711,-3574
sn51.77,0.3917861379283405,69,315,2120,-1805
sn51.78,0.3917861379283405,69,315,2120,-1805
sn51.79,0.3917861379283405,69,315,2120,-1805
sn51.80,0.3917861379283405,69,315,2120,-1805
sn51.81,0.3917861379283405,69,315,2120,-1805
sn51.82,0.3917861379283405,69,315,2120,-1805
sn51.83,0.3917861379283405,69,315,2120,-1805
sn51.84,0.3917861379283405,69,315,2120,-1805
sn51.85,0.3917861379283405,69,315,2120,-1805
sn51.86,0.3917861379283405,69,315,2120,-1805
sn52.1,0.5236829834569745,395,230,1659,-1429
sn52.2,0.5284504170595339,174,217,1786,-1569
sn52.3,0.3468920615173898,105,298,2203,-1905
sn52.4,0.41852801710120513,97,244,2058,-1814
sn52.5,0.3280227014695214,60,198,2283,-2085
sn52.6,0.2612837037233362,73,293,2404,-2111
sn52.7,0.47894455965282745,60,435,1851,-1416
sn52.8,0.4615555530486537,191,348,1845,-1497
sn52.9,0.2501459307610254,124,313,2486,-2173
sn52.10,0.28589709726876134,98,245,2335,-2090
sn52.11,0.23692413824532021,90,317,2430,-2113
sn52.12,4.376269051586945e-05,21,88,3234,-3146
sn52.13,4.376269051586945e-05,22,84,2921,-2837
sn52.14,4.376269051586945e-05,27,127,3252,-3125
sn52.15,4.376269049366499e-05,13,139,3287,-3148
sn52.16,4.376269051586945e-05,14,196,2982,-2786
sn52.17,4.376269049366499e-05,10,215,2914,-2699
sn52.18,4.376269051586945e-05,10,185,3087,-2902
sn52.19,4.376269049366499e-05,11,186,3060,-2874
sn52.20,4.376269049366499e-05,12,157,3254,-3097
sn52.21,4.376269049366499e-05,13,134,3161,-3027
sn52.22,4.376269049366499e-05,23,103,3255,-3152
sn52.23,4.376269051586945e-05,26,107,3379,-3272
sn52.24,4.376269056027837e-05,30,227,2555,-2328
sn53.1,0.5392318975174337,175,435,1543,-1108
sn53.2,0.5392318975174337,175,435,1543,-1108
sn53.3,0.5392318975174337,175,435,1543,-1108
sn53.4,0.5392318975174337,175,435,1543,-1108
sn53.5,0.5392318975174337,175,435,1543,-1108
sn53.6,0.5392318975174337,175,435,1543,-1108
sn53.7,0.5392318975174337,175,435,1543,-1108
sn53.8,0.5392318975174337,175,435,1543,-1108
sn53.9,0.5392318975174337,175,435,1543,-1108
sn53.10,0.5392318975174337,175,435,1543,-1108
sn53.11,0.5392318975174337,175,435,1543,-1108
sn53.12,0.5392318975174337,175,435,1543,-1108
sn53.13,4.376269049366499e-05,13,97,3980,-3883
sn53.14,4.376269049366499e-05,13,97,3980,-3883
sn53.15,4.376269049366499e-05,13,97,3980,-3883
sn53.16,4.376269049366499e-05,13,97,3980,-3883
sn53.17,4.376269049366499e-05,13,97,3980,-3883
sn53.18,4.376269049366499e-05,13,97,3980,-3883
sn53.19,4.376269049366499e-05,13,97,3980,-3883
sn53.20,4.376269049366499e-05,13,97,3980,-3883
sn53.21,4.376269049366499e-05,13,97,3980,-3883
sn53.22,4.376269049366499e-05,13,97,3980,-3883
sn53.23,4.376269049366499e-05,15,108,3811,-3703
sn53.24,4.376269049366499e-05,15,108,3811,-3703
sn53.25,4.376269049366499e-05,15,108,3811,-3703
sn53.26,4.376269049366499e-05,15,108,3811,-3703
sn53.27,4.376269049366499e-05,15,108,3811,-3703
sn53.28,4.376269049366499e-05,15,108,3811,-3703
sn53.29,4.376269049366499e-05,15,108,3811,-3703
sn53.30,4.376269049366499e-05,15,108,3811,-3703
sn53.31,4.376269049366499e-05,15,108,3811,-3703
sn53.32,4.376269049366499e-05,15,108,3811,-3703
sn53.33,4.376269049366499e-05,15,108,3811,-3703
sn53.34,4.376269049366499e-05,15,108,3811,-3703
sn53.35,4.376269051586945e-05,16,137,3711,-3574
sn53.36,4.376269051586945e-05,16,137,3711,-3574
sn53.37,4.376269051586945e-05,16,137,3711,-3574
sn53.38,4.376269051586945e-05,16,137,3711,-3574
sn53.39,4.376269051586945e-05,16,137,3711,-3574
sn53.40,4.376269051586945e-05,16,137,3711,-3574
sn53.41,4.376269051586945e-05,16,137,3711,-3574
sn53.42,4.376269051586945e-05,16,137,3711,-3574
sn53.43,4.376269051586945e-05,16,137,3711,-3574
sn53.44,4.376269051586945e-05,16,137,3711,-3574
sn53.45,0.3178142854345367,95,276,2270,-1994
sn53.46,0.3178142854345367,95,276,2270,-1994
sn53.47,0.3178142854345367,95,276,2270,-1994
sn53.48,0.3178142854345367,95,276,2270,-1994
sn53.49,0.3178142854345367,95,276,2270,-1994
sn53.50,0.3178142854345367,95,276,2270,-1994
sn53.51,0.3178142854345367,95,276,2270,-1994
sn53.52,0.3178142854345367,95,276,2270,-1994
sn53.53,0.3178142854345367,95,276,2270,-1994
sn53.54,0.3178142854345367,95,276,2270,-1994
sn54.1,0.12390905280055264,173,53,3128,-3075
sn54.2,0.06714526741871119,50,327,2975,-2648
sn54.3,0.0626875562409479,59,96,3460,-3364
sn54.4,0.10729335406642893,77,100,3190,-3090
sn54.5,0.21076025226356432,132,158,2574,-2416
sn54.6,0.3049920443092491,136,39,2352,-2313
sn54.7,0.15008365090316556,208,32,2934,-2902
sn54.8,0.3425242137245599,504,143,2216,-2073
sn54.9,0.4274996661387087,347,80,2036,-1956
sn54.10,0.4832087754683245,470,245,1849,-1604
sn54.11,0.3349739453063938,194,110,2248,-2138
sn54.12,0.483359542628814,386,220,1941,-1721
sn54.13,0.5891171438987763,779,496,1561,-1065
sn54.14,0.32379809417031336,139,293,2252,-1959
sn54.15,0.3633923093422142,137,286,2166,-1880
sn54.16,0.6048960112996049,796,465,1543,-1078
sn54.17,4.376269051586945e-05,9,112,3373,-3261
sn54.18,4.376269049366499e-05,4,71,3995,-3924
sn54.19,4.376269049366499e-05,4,48,4213,-4165
sn54.20,0.2272331467017663,73,122,2490,-2368
sn55.1,0.5771911592131973,180,266,1691,-1425
sn55.2,0.3660311462236443,79,372,2167,-1795
sn55.3,0.610228040668126,413,123,1508,-1385
sn55.4,0.6426750763933731,106,276,1762,-1486
sn55.5,0.3887908187108158,133,155,2063,-1908
sn55.6,0.3534757362116281,795,68,2189,-2121
sn55.7,0.7695694863913083,741,292,1475,-1183
sn55.8,0.6333207881575431,236,196,1753,-1557
sn55.9,0.34544997007126543,83,124,2196,-2072
sn55.10,0.3611152452325461,282,154,2126,-1972
sn55.11,0.5978599672627816,81,358,1753,-1395
sn55.12,0.4359070000300447,148,153,2036,-1883
sn55.13,0.6148156015699957,294,619,1719,-1100
sn55.14,0.12305648561803384,53,310,2848,-2538
sn55.15,0.11817557280424662,53,310,2852,-2542
sn55.16,4.376269051586945e-05,77,33,3449,-3416
sn55.17,0.06833880117664837,138,96,2949,-2853
sn55.18,0.3752979902910347,182,470,2152,-1682
sn55.19,0.37540742730493015,179,452,2151,-1699
sn55.20,0.5243373956022479,162,127,1864,-1737
sn55.21,0.4054756991183739,278,56,1962,-1906
sn55.22,0.568858943901307,181,256,1795,-1539
sn55.23,0.3434851507613468,506,193,2221,-2028
sn55.24,0.5598820797618753,551,195,1659,-1464
sn55.25,0.760079022714355,638,196,1244,-1048
sn55.26,0.5078043797380971,817,481,1947,-1466
sn55.27,0.29836479354976575,503,164,2452,-2288
sn55.28,0.6570427545131485,260,246,1479,-1233
sn55.29,0.2948262372341359,39,95,2364,-2269
sn55.30,0.4120573989591092,175,150,1953,-1803
sn55.31,0.25755463003567236,95,117,2553,-2436
sn55.32,0.12812253058462897,64,129,2739,-2610
sn55.33,0.23972078650138506,64,161,2398,-2237
sn55.34,0.2100762515881982,83,237,2745,-2508
sn55.35,0.2692906759524716,139,249,2374,-2125
sn55.36,0.16265732913256503,114,177,2727,-2550
sn55.37,0.3194305233156891,152,120,2324,-2204
sn55.38,0.2079504928188758,59,25,2723,-2698
sn55.39,0.47523655809385,153,143,1888,-1745
sn55.40,0.5066840750530099,356,150,1796,-1646
sn55.41,0.23318092206012775,169,66,2586,-2520
sn55.42,0.2547809070395868,178,65,2559,-2494
sn55.43,0.4656146058860555,107,106,1968,-1862
sn55.44,0.13737380985492376,54,313,2755,-2442
sn55.45,0.12590623493660136,56,291,2816,-2525
sn55.46,0.15409605593463827,56,377,2622,-2245
sn55.47,0.3413556142515928,65,332,2230,-1898
sn55.48,0.33119066300888456,56,305,2237,-1932
sn55.49,0.35854708028320026,57,319,2176,-1857
sn55.50,0.14324097447704354,24,117,2858,-2741
sn55.51,0.24912800348146913,91,298,2485,-2187
sn55.52,0.4407970244219017,223,219,1997,-1778
sn55.53,0.6428279764616907,190,151,1581,-1430
sn55.54,0.3035414686551885,415,73,2310,-2237
sn55.55,0.1760016133941944,21,290,2655,-2365
sn55.56,4.376269049366499e-05,13,247,3262,-3015
sn55.57,4.376269051586945e-05,4,42,4198,-4156
sn55.58,4.376269051586945e-05,4,67,3925,-3858
sn55.59,4.376269051586945e-05,4,72,3880,-3808
sn55.60,4.376269049366499e-05,4,38,4294,-4256
sn55.61,4.376269049366499e-05,13,25,4091,-4066
sn55.62,0.19547670895863067,21,312,2601,-2289
sn55.63,4.376269049366499e-05,3,33,4295,-4262
sn55.64,4.376269049366499e-05,3,30,4231,-4201
sn55.65,4.376269049366499e-05,3,28,4228,-4200
sn55.66,4.376269049366499e-05,3,46,4145,-4099
sn55.67,4.376269049366499e-05,3,33,4295,-4262
sn55.68,4.376269049366499e-05,3,33,4295,-4262
sn55.69,4.376269049366499e-05,3,33,4295,-4262
sn55.70,4.376269049366499e-05,3,33,4295,-4262
sn55.71,4.376269049366499e-05,3,33,4295,-4262
sn55.72,4.376269049366499e-05,3,33,4227,-4194
sn55.73,4.376269049366499e-05,3,53,3794,-3741
sn55.74,0.25200814999639665,31,164,2369,-2205
sn56.1,4.376269053807391e-05,59,264,3099,-2835
sn56.2,4.376269051586945e-05,54,252,3257,-3005
sn56.3,0.1364048628204717,101,194,2622,-2428
sn56.4,0.1571976203191605,104,232,2633,-2401
sn56.5,0.1000396709312179,99,314,2851,-2537
sn56.6,0.07032401850768366,107,191,2915,-2724
sn56.7,0.13121736564933872,81,121,2739,-2618
sn56.8,0.19772889545734973,128,363,2498,-2135
sn56.9,0.18496814299868714,90,69,2712,-2643
sn56.10,0.23174978111411004,115,125,2408,-2283
sn56.11,0.47960434789762196,614,133,1872,-1739
sn56.12,4.376269051586945e-05,208,50,3400,-3350
sn56.13,0.27114738807088035,97,293,2376,-2083
sn56.14,0.2780208098458692,98,264,2345,-2081
sn56.15,0.08999291732296744,146,115,2821,-2706
sn56.16,0.18072789403693612,256,209,2480,-2271
sn56.17,0.24741415679792045,52,141,2441,-2300
sn56.18,0.4208266884804024,64,200,2104,-1904
sn56.19,4.376269051586945e-05,57,107,3090,-2983
sn56.20,4.376269049366499e-05,59,79,3281,-3202
sn56.21,0.1472687452029442,106,75,2830,-2755
sn56.22,0.3217646447569944,162,233,2256,-2023
sn56.23,0.31208819687853495,42,242,2244,-2002
sn56.24,0.17723104645066545,91,191,2739,-2548
sn56.25,4.376269051586945e-05,68,128,3421,-3293
sn56.26,0.177662885575125,74,144,2557,-2413
sn56.27,4.376269049366499e-05,37,178,3024,-2846
sn56.28,4.376269051586945e-05,39,191,2815,-2624
sn56.29,4.376269049366499e-05,65,125,3037,-2912
sn56.30,0.235571791407585,105,219,2470,-2251
sn56.31,0.20679596990154092,141,121,2646,-2525
sn56.32,0.20604821964929076,156,212,2548,-2336
sn56.33,0.1834231044850254,61,77,2529,-2452
sn56.34,4.376269051586945e-05,85,92,3080,-2988
sn56.35,0.16828528781818175,105,90,2735,-2645
sn56.36,0.18639300789284885,109,100,2663,-2563
sn56.37,4.376269051586945e-05,51,210,2653,-2443
sn56.38,0.10934022372575125,142,68,2781,-2713
sn56.39,0.34453861826329035,270,211,2209,-1998
sn56.40,0.22312552733572133,249,114,2680,-2566
sn56.41,0.42026659916629683,297,135,2073,-1938
sn56.42,0.3029832866696003,288,202,2301,-2099
sn56.43,0.347091870414018,238,136,2205,-2069
sn56.44,0.1389304600710739,132,217,2571,-2354
sn56.45,0.3912865960860268,183,45,2075,-2030
sn56.46,0.31209657823492165,191,174,2313,-2139
sn56.47,0.1329090824417456,114,47,2899,-2852
sn56.48,0.08535468208572539,124,35,3101,-3066
sn56.49,0.2912907315426594,106,178,2328,-2150
sn56.50,0.24695681672184389,129,148,2469,-2321
sn56.51,0.22056210465126735,109,153,2489,-2336
sn56.52,0.06103879800398726,66,35,3318,-3283
sn56.53,0.13598619446473226,74,98,2859,-2761
sn56.54,0.08262909493816917,84,92,3072,-2980
sn56.55,0.013911602590033212,57,72,3605,-3533
sn56.56,4.376269056027837e-05,66,68,3676,-3608
sn56.57,0.01894710704415381,67,53,3354,-3301
sn56.58,4.376269053807391e-05,77,49,3480,-3431
sn56.59,4.376269053807391e-05,61,69,3534,-3465
sn56.60,0.20033859760375528,129,151,2577,-2426
sn56.61,0.3172005960236701,99,146,2317,-2171
sn56.62,0.08452688224303007,75,95,3145,-3050
sn56.63,4.376269051586945e-05,23,137,3473,-3336
sn56.64,4.376269051586945e-05,21,122,3665,-3543
sn56.65,4.376269051586945e-05,22,159,3034,-2875
sn56.66,4.376269049366499e-05,19,151,3463,-3312
sn56.67,4.376269051586945e-05,19,151,3458,-3307
sn56.68,4.376269051586945e-05,19,151,3458,-3307
sn56.69,4.376269051586945e-05,19,152,3455,-3303
sn56.70,4.376269049366499e-05,29,103,3569,-3466
sn56.71,4.376269049366499e-05,24,197,2940,-2743
sn56.72,4.376269049366499e-05,21,160,3408,-3248
sn56.73,4.376269051586945e-05,21,193,3391,-3198
sn56.74,4.376269049366499e-05,21,159,3407,-3248
sn56.75,4.376269049366499e-05,23,158,3153,-2995
sn56.76,4.376269049366499e-05,23,158,3153,-2995
sn56.77,4.376269049366499e-05,21,154,3432,-3278
sn56.78,4.376269051586945e-05,21,91,3720,-3629
sn56.79,4.376269049366499e-05,21,133,3493,-3360
sn56.80,4.376269051586945e-05,30,113,3139,-3026
sn56.81,4.376269051586945e-05,24,99,3312,-3213
sn56.82,4.376269049366499e-05,21,124,3332,-3208
sn56.83,4.376269051586945e-05,21,122,3609,-3487
sn56.84,4.376269049366499e-05,21,108,3669,-3561
sn56.85,4.376269049366499e-05,21,107,3671,-3564
sn56.86,4.376269049366499e-05,21,114,3432,-3318
sn56.87,4.376269049366499e-05,21,108,3669,-3561
sn56.88,4.376269049366499e-05,21,119,3371,-3252
sn56.89,4.376269049366499e-05,21,108,3694,-3586
sn56.90,4.376269051586945e-05,29,112,3636,-3524
sn56.91,4.376269049366499e-05,21,115,3623,-3508
sn56.92,4.376269051586945e-05,21,131,3496,-3365
sn56.93,4.376269049366499e-05,21,101,3692,-3591
sn56.94,4.376269051586945e-05,21,84,3728,-3644
sn56.95,4.376269049366499e-05,21,83,3750,-3667
sn56.96,0.32177562613970867,56,178,2247,-2069
sn56.97,0.32177562613970867,56,178,2247,-2069
sn56.98,0.32177562613970867,56,178,2247,-2069
sn56.99,0.32177562613970867,56,178,2247,-2069
sn56.100,0.32177562613970867,56,178,2247,-2069
sn56.101,0.32177562613970867,56,178,2247,-2069
sn56.102,0.0935261537786003,76,97,3053,-2956
sn56.103,4.376269051586945e-05,25,120,3514,-3394
sn56.104,4.376269049366499e-05,25,130,3528,-3398
sn56.105,4.376269049366499e-05,35,100,3615,-3515
sn56.106,4.376269049366499e-05,35,100,3615,-3515
sn56.107,4.376269049366499e-05,35,100,3615,-3515
sn56.108,4.376269051586945e-05,35,99,3431,-3332
sn56.109,4.376269051586945e-05,35,99,3431,-3332
sn56.110,4.376269051586945e-05,35,99,3431,-3332
sn56.111,4.376269051586945e-05,35,100,3429,-3329
sn56.112,4.376269051586945e-05,35,100,3429,-3329
sn56.113,4.376269051586945e-05,35,100,3429,-3329
sn56.114,4.376269049366499e-05,35,99,3654,-3555
sn56.115,4.376269049366499e-05,35,99,3654,-3555
sn56.116,4.376269049366499e-05,35,99,3654,-3555
sn56.117,4.376269049366499e-05,35,99,3655,-3556
sn56.118,4.376269049366499e-05,35,99,3655,-3556
sn56.119,4.376269049366499e-05,35,99,3655,-3556
sn56.120,4.376269049366499e-05,35,88,3688,-3600
sn56.121,4.376269049366499e-05,35,88,3688,-3600
sn56.122,4.376269049366499e-05,35,88,3688,-3600
sn56.123,4.376269049366499e-05,35,88,3689,-3601
sn56.124,4.376269049366499e-05,35,88,3689,-3601
sn56.125,4.376269049366499e-05,35,88,3689,-3601
sn56.126,4.376269049366499e-05,35,96,3660,-3564
sn56.127,4.376269049366499e-05,35,96,3660,-3564
sn56.128,4.376269049366499e-05,35,96,3660,-3564
sn56.129,4.376269049366499e-05,49,110,3533,-3423
sn56.130,4.376269049366499e-05,49,110,3533,-3423
sn56.131,0.36544746345266166,86,181,2155,-1974
an1.1-10,0.02519187161287295,215,108,3611,-3503
an1.11-20,4.376269053807391e-05,301,74,3130,-3056
an1.140-149,4.376269049366499e-05,143,48,3402,-3354
an1.150-169,4.376269049366499e-05,271,36,3487,-3451
an1.170-187,0.14622424200994022,224,78,2774,-2696
an1.188-197,4.376269051586945e-05,53,96,3494,-3398
an1.198-208,4.376269051586945e-05,54,85,3661,-3576
an1.209-218,4.376269051586945e-05,51,87,3232,-3145
an1.21-30,4.376269049366499e-05,195,106,3677,-3571
an1.219-234,4.376269051586945e-05,71,93,3475,-3382
an1.235-247,4.376269051586945e-05,60,83,3552,-3469
an1.248-257,4.376269051586945e-05,63,131,3260,-3129
an1.258-267,4.376269049366499e-05,54,84,3638,-3554
an1.268-277,4.376269049366499e-05,241,88,3751,-3663
an1.278-286,4.376269051586945e-05,170,82,3551,-3469
an1.287-295,4.376269049366499e-05,215,367,3075,-2708
an1.296-305,4.376269051586945e-05,75,90,3912,-3822
an1.306-315,0.5839578575246085,490,282,1766,-1484
an1.31-40,4.376269049366499e-05,203,83,3761,-3678
an1.316-332,0.3210436691948537,304,86,2256,-2170
an1.333-377,0.12434498503397506,636,147,3105,-2958
an1.378-393,4.376269051586945e-05,37,51,3338,-3287
an1.394-574,0.3458419741083629,629,333,2209,-1876
an1.41-50,0.44530351062148643,357,143,2034,-1891
an1.51-60,0.500133315198803,228,171,1794,-1623
an1.575-615,0.23113078018417443,420,119,2558,-2439
an1.61-70,4.376269051586945e-05,305,168,3238,-3070
an1.616-627,4.376269051586945e-05,172,45,3822,-3777
an1.71-81,0.19862546032993755,266,180,2639,-2459
an1.82-97,4.376269051586945e-05,293,72,3592,-3520
an1.98-139,4.376269051586945e-05,509,91,3294,-3203
an10.104,0.33952412751907524,267,55,2214,-2159
an2.1-10,0.7153018396213628,792,57,1164,-1107
an2.11-20,1.2572729734353638,1396,610,877,-267
an2.118-129,4.376269051586945e-05,214,136,2934,-2798
an2.130-140,0.1660346267662094,545,71,2697,-2626
an2.141-150,0.0819135991121378,199,179,2886,-2707
an2.151-162,0.19133855011186363,235,211,2575,-2364
an2.163-179,0.030696963961074353,220,306,2814,-2508
an2.180-229,0.2963990513192627,407,279,2303,-2024
an2.21-31,0.2828436653598665,299,202,2318,-2116
an2.230-279,4.376269049366499e-05,79,134,3493,-3359
an2.280-309,0.065172827796256,246,19,3354,-3335
an2.310-479,4.376269049366499e-05,121,297,2945,-2648
an2.32-41,1.30732995594951,1440,360,887,-527
an2.42-51,0.3564217185755503,1029,52,2180,-2128
an2.52-63,0.2438818413488919,592,66,2492,-2426
an2.64-76,0.016259992321798755,253,76,3073,-2997
an2.77-86,4.376269051586945e-05,171,123,3507,-3384
an2.87-97,4.376269051586945e-05,139,303,2900,-2597
an2.98-117,4.376269051586945e-05,383,118,2881,-2763
an3.1,0.1924646977986333,154,70,2549,-2479
an3.10,4.376269051586945e-05,97,207,3173,-2966
an3.100,0.32029840976950386,800,34,2320,-2286
an3.101,0.5217152874755326,627,87,1757,-1670
an3.102,0.11667890001938463,372,69,2832,-2763
an3.103,0.3011372274431823,112,144,2300,-2156
an3.104,0.08051499169885457,109,92,2864,-2772
an3.105,4.376269051586945e-05,122,197,3114,-2917
an3.106,4.376269049366499e-05,89,172,3105,-2933
an3.107,4.376269049366499e-05,31,40,3597,-3557
an3.108,4.376269051586945e-05,28,36,3782,-3746
an3.109,0.021746636250985496,272,13,3623,-3610
an3.11,4.376269049366499e-05,89,209,3357,-3148
an3.110,4.376269051586945e-05,126,34,3827,-3793
an3.111,4.376269051586945e-05,201,55,3666,-3611
an3.112,0.08965728831635822,327,70,3259,-3189
an3.113,0.08108836613793802,38,86,2995,-2909
an3.114,4.376269049366499e-05,32,97,3529,-3432
an3.115,0.10922987436823295,83,156,2972,-2816
an3.116,0.32549370108074793,275,263,2267,-2004
an3.117,0.5493901303112336,288,647,1931,-1284
an3.118,0.5495510487532496,255,581,1832,-1251
an3.119,0.39655005983256775,153,300,2102,-1802
an3.12,0.08280982513311219,166,86,2809,-2723
an3.120,0.056064124378996105,68,163,2919,-2756
an3.121,0.10019133029981475,286,182,3079,-2897
an3.122,0.27867092405484684,92,171,2366,-2195
an3.123,0.2674842715751913,256,76,2420,-2344
an3.124,4.376269051586945e-05,176,89,2952,-2863
an3.125,0.1590312827746576,88,62,2625,-2563
an3.126,0.1683908283776736,348,33,2679,-2646
an3.127,0.38312725306874906,209,52,2105,-2053
an3.128,0.22008528545522932,197,26,2668,-2642
an3.129,0.3508854714258991,103,539,2191,-1652
an3.13,0.29735117993525684,367,159,2430,-2271
an3.130,0.4547544546974924,190,295,2009,-1714
an3.131,4.376269051586945e-05,69,21,3828,-3807
an3.132,0.16436348572923531,173,89,3227,-3138
an3.133,0.5662170183896587,311,270,1721,-1451
an3.134,4.376269049366499e-05,16,139,3939,-3800
an3.135,4.376269049366499e-05,22,143,3807,-3664
an3.136,4.376269051586945e-05,93,34,3532,-3498
an3.137,4.376269051586945e-05,140,57,3236,-3179
an3.138,4.376269049366499e-05,13,153,4010,-3857
an3.139,4.376269051586945e-05,13,139,4060,-3921
an3.14,0.13755788189353524,252,34,2788,-2754
an3.140,0.3253878634822627,285,98,2257,-2159
an3.141,0.26927865356611846,282,77,2531,-2454
an3.142,0.36578973172887164,140,83,2170,-2087
an3.143,0.16179806131184638,53,107,2587,-2480
an3.144,0.07470669641109762,31,108,2727,-2619
an3.145,4.376269051586945e-05,39,115,3171,-3056
an3.146,4.376269049366499e-05,49,229,3796,-3567
an3.147,4.376269049366499e-05,46,214,3811,-3597
an3.148,4.376269051586945e-05,34,68,3946,-3878
an3.149,4.376269049366499e-05,36,87,3899,-3812
an3.15,0.21980981694977864,468,31,2691,-2660
an3.150,4.376269049366499e-05,79,154,3747,-3593
an3.151,4.376269049366499e-05,27,38,4298,-4260
an3.152,4.376269049366499e-05,27,39,4295,-4256
an3.153,4.376269049366499e-05,45,55,3829,-3774
an3.154,4.376269049366499e-05,13,155,3635,-3480
an3.155,4.376269051586945e-05,89,195,3269,-3074
an3.156-162,0.5202503756392751,473,447,1625,-1178
an3.16,0.5544251578817327,229,140,1734,-1594
an3.163-182,4.376269051586945e-05,351,130,3581,-3451
an3.17,4.376269051586945e-05,53,64,3819,-3755
an3.18,4.376269049366499e-05,57,35,3507,-3472
an3.183-352,0.3035691837414145,143,206,2336,-2130
an3.19,0.07045166933175029,211,115,3169,-3054
an3.2,4.376269049366499e-05,72,274,3240,-2966
an3.20,0.4391657633108226,283,111,1904,-1793
an3.21,0.33449580426196945,493,299,2232,-1933
an3.22,0.1175321997584744,269,23,3318,-3295
an3.23,0.16691332542606574,170,34,2812,-2778
an3.24,0.3127803751777458,113,259,2278,-2019
an3.25,0.4186562052206799,183,254,2029,-1775
an3.26,0.13938830113933154,237,83,2941,-2858
an3.27,0.13826615206666837,324,75,3101,-3026
an3.28,0.22116712173267938,175,111,2611,-2500
an3.29,0.12542660636027936,216,66,2891,-2825
an3.3,0.0556707192820971,133,42,3185,-3143
an3.30,0.26442624203515397,509,107,2530,-2423
an3.31,4.376269051586945e-05,92,22,3332,-3310
an3.32,0.24927485630508173,175,120,2543,-2423
an3.33,0.3783793323438145,154,141,2126,-1985
an3.34,0.1825150678359755,391,57,2946,-2889
an3.35,0.3606593244774414,291,35,2175,-2140
an3.36,0.36047558868532725,782,55,2158,-2103
an3.37,0.2253158483875639,275,32,2704,-2672
an3.38,0.18905151138051135,105,75,2589,-2514
an3.39,0.2941151281265375,411,160,2332,-2172
an3.4,4.376269049366499e-05,66,200,3650,-3450
an3.40,0.5323133762679566,494,103,1638,-1535
an3.41,4.376269049366499e-05,44,46,4003,-3957
an3.42,4.376269051586945e-05,40,80,3374,-3294
an3.43,0.17079031181574944,52,155,2491,-2336
an3.44,0.1658010344944172,48,155,2447,-2292
an3.45,4.376269051586945e-05,45,31,3624,-3593
an3.46,4.376269049366499e-05,40,87,3321,-3234
an3.47,4.376269049366499e-05,40,88,3158,-3070
an3.48,0.09384164503984938,94,66,3614,-3548
an3.49,4.376269053807391e-05,78,74,3458,-3384
an3.5,4.376269049366499e-05,75,223,3665,-3442
an3.50,0.13362329208876922,287,56,3059,-3003
an3.51,0.15360498433938385,133,36,2804,-2768
an3.52,0.12165904703069774,140,39,2930,-2891
an3.53,0.10792772583845256,262,75,2931,-2856
an3.54,0.08800900222898367,247,134,2938,-2804
an3.55,0.036437165892766465,156,78,3515,-3437
an3.56,0.19292831994996984,216,67,2562,-2495
an3.57,0.5278022675325067,389,99,1780,-1681
an3.58,0.9105150482871638,593,351,1181,-830
an3.59,0.5373094151912561,395,237,1780,-1543
an3.6,4.376269049366499e-05,47,237,3731,-3494
an3.60,0.7614158500953039,1124,173,950,-777
an3.61,0.5629123209779596,915,198,1460,-1262
an3.62,0.1027303587111561,467,12,3020,-3008
an3.63,0.5481195696878105,878,251,1626,-1375
an3.64,0.3646375708255656,596,32,2167,-2135
an3.65,0.7370468856592316,994,102,1366,-1264
an3.66,0.47416760069052266,679,79,1911,-1832
an3.67,0.1440437566657904,383,100,2996,-2896
an3.68,0.3805293308721369,396,266,2137,-1871
an3.69,0.3334036931792239,707,56,2244,-2188
an3.7,4.376269051586945e-05,26,49,3926,-3877
an3.70,0.47820377844611794,1904,32,1701,-1669
an3.71,0.2825754445493489,363,198,2406,-2208
an3.72,0.25750011502709835,402,160,2376,-2216
an3.73,0.5656933387730323,241,116,1768,-1652
an3.74,0.4445115967407265,262,69,1898,-1829
an3.75,0.32194602123361005,204,121,2287,-2166
an3.76,0.4187875611197267,129,234,2065,-1831
an3.77,0.32093212846227015,128,185,2257,-2072
an3.78,0.11617894802355977,108,80,2579,-2499
an3.79,0.2677942444562431,258,97,2602,-2505
an3.8,4.376269051586945e-05,59,233,3260,-3027
an3.80,0.28887262844017325,347,112,2355,-2243
an3.81,4.376269051586945e-05,39,66,3239,-3173
an3.82,4.376269051586945e-05,111,65,2945,-2880
an3.83,0.05650380566410984,80,54,3049,-2995
an3.84,0.03983934305822334,145,25,3189,-3164
an3.85,0.15339900609880885,65,50,2515,-2465
an3.86,0.34678066226094817,267,163,2212,-2049
an3.87,0.4536496572230986,278,233,1962,-1729
an3.88,0.3032977437768425,226,149,2297,-2148
an3.89,0.1954914635228011,73,206,2679,-2473
an3.9,4.376269049366499e-05,93,200,3633,-3433
an3.90,0.27066728996347766,124,188,2356,-2168
an3.91,0.4889138569465157,649,73,1891,-1818
an3.92,0.11653395091104635,160,31,2949,-2918
an3.93,0.05589213683072636,333,5,3536,-3531
an3.94,0.21246895557716083,74,98,2570,-2472
an3.95,0.2338265421857555,228,112,2516,-2404
an3.96,0.3391371208735894,166,276,2214,-1938
an3.97,0.17803858772287295,157,203,2758,-2555
an3.98,0.31361757238907995,161,231,2375,-2144
an3.99,0.27509450100529076,385,89,2414,-2325
an4.1,0.1689939774639715,130,16,2848,-2832
an4.10,0.30753402761687365,420,114,2422,-2308
an4.100,0.24561138857921438,470,151,2516,-2365
an4.101,0.15529770574873591,226,55,3209,-3154
an4.102,0.21220561518051628,283,106,2742,-2636
an4.103,0.20089789453783258,243,137,2552,-2415
an4.104,0.1923022064783675,243,124,2594,-2470
an4.105,0.20269045249738937,243,161,2543,-2382
an4.107,0.19295134366308364,301,76,2798,-2722
an4.108,0.07050026021906408,203,50,3516,-3466
an4.109,0.10580794248205017,185,111,3047,-2936
an4.11,0.04636090725842479,289,36,3200,-3164
an4.110,0.0933541569086982,232,59,3343,-3284
an4.111,0.10771315761715083,325,73,3078,-3005
an4.112,4.376269049366499e-05,69,235,3628,-3393
an4.113,0.17190398134396823,564,31,3020,-2989
an4.114,0.2661033423403625,336,179,2498,-2319
an4.115,4.376269051586945e-05,274,77,3333,-3256
an4.116,4.376269049366499e-05,71,55,3374,-3319
an4.117,4.376269049366499e-05,101,88,3204,-3116
an4.118,4.376269049366499e-05,60,45,3632,-3587
an4.119,4.376269049366499e-05,13,54,4007,-3953
an4.12,0.06623739984348287,208,46,2937,-2891
an4.120,4.376269049366499e-05,25,93,3762,-3669
an4.121,0.2686148142480471,357,36,2466,-2430
an4.122,0.27152732152397885,608,52,2530,-2478
an4.123,0.43035982379284743,392,268,1999,-1731
an4.124,0.15110649211735883,126,398,2587,-2189
an4.125,0.44414851490979235,263,240,1994,-1754
an4.126,0.26135234093269677,162,379,2374,-1995
an4.127,0.20456356604965364,299,165,2511,-2346
an4.128,0.10625042591791978,128,59,2838,-2779
an4.129,0.08561957406827414,121,39,2741,-2702
an4.13,0.050903791888923244,85,133,3134,-3001
an4.130,0.18716397454192624,228,32,2589,-2557
an4.131,0.032715985667830516,181,85,3474,-3389
an4.132,4.376269051586945e-05,29,28,3616,-3588
an4.133,4.376269049366499e-05,19,195,3569,-3374
an4.134,4.376269049366499e-05,29,9,3848,-3839
an4.135,4.376269053807391e-05,142,170,3174,-3004
an4.136,4.376269051586945e-05,66,134,3317,-3183
an4.137,4.376269051586945e-05,80,58,3336,-3278
an4.138,0.05499862859175142,152,91,3290,-3199
an4.139,0.06793575743551106,92,37,3058,-3021
an4.14,0.5566441591018378,193,481,1667,-1186
an4.140,4.376269051586945e-05,67,14,3250,-3236
an4.141,4.376269051586945e-05,21,94,3898,-3804
an4.142,4.376269049366499e-05,21,92,3901,-3809
an4.143,4.376269051586945e-05,20,147,3393,-3246
an4.144,4.376269051586945e-05,20,147,3393,-3246
an4.145,4.376269049366499e-05,20,159,3384,-3225
an4.146,4.376269049366499e-05,17,125,3630,-3505
an4.147,0.04780291343688958,78,41,2947,-2906
an4.148,4.376269049366499e-05,15,66,3913,-3847
an4.149,4.376269049366499e-05,15,43,3967,-3924
an4.15,4.376269049366499e-05,54,100,3367,-3267
an4.150,4.376269051586945e-05,30,112,3176,-3064
an4.151,4.376269049366499e-05,13,121,3922,-3801
an4.152,4.376269049366499e-05,13,114,3964,-3850
an4.153,4.376269049366499e-05,13,109,3973,-3864
an4.154,4.376269049366499e-05,13,103,3973,-3870
an4.155,4.376269049366499e-05,13,130,3378,-3248
an4.156,4.376269051586945e-05,87,58,3832,-3774
an4.157,0.1738217865020708,170,47,2868,-2821
an4.158,0.32630868421053005,123,227,2223,-1996
an4.159,0.5156720260291126,496,248,1873,-1625
an4.16,0.1748002119725145,146,44,2600,-2556
an4.160,0.49386415532459704,364,150,1611,-1461
an4.161,4.376269049366499e-05,22,128,3906,-3778
an4.162,0.07757842517781555,254,114,3070,-2956
an4.163,0.4373362301816952,317,329,1961,-1632
an4.164,0.3125686860955268,175,138,2281,-2143
an4.165,0.3543316411843689,188,141,2187,-2046
an4.166,4.376269049366499e-05,103,93,3855,-3762
an4.167,0.10959380753812198,100,261,2909,-2648
an4.168,0.08816919978660298,100,258,2941,-2683
an4.169,0.5600601445907571,305,539,1958,-1419
an4.17,4.376269049366499e-05,28,63,3473,-3410
an4.170,0.3132566891001831,199,253,2342,-2089
an4.171,0.49312514635648785,499,104,1802,-1698
an4.172,0.2019690183279632,154,42,2665,-2623
an4.173,4.376269053807391e-05,191,204,3176,-2972
an4.174,4.376269051586945e-05,190,199,3172,-2973
an4.175,0.0888953573117357,165,223,2962,-2739
an4.176,4.376269049366499e-05,109,73,3475,-3402
an4.177,0.18742888894689447,157,196,2763,-2567
an4.178,0.2384994667856022,349,48,2428,-2380
an4.179,0.2303815597861414,124,268,2358,-2090
an4.18,4.376269049366499e-05,32,63,3473,-3410
an4.180,0.31638316075153217,635,49,2297,-2248
an4.181,0.5902571169907,243,269,1708,-1439
an4.182,4.376269051586945e-05,127,104,3212,-3108
an4.183,0.17457831428613346,254,125,2644,-2519
an4.184,0.14169946654540855,554,78,3255,-3177
an4.185,0.27953193298182466,264,71,2440,-2369
an4.186,0.5221033940943531,333,89,1932,-1843
an4.187,0.12812519584863846,425,108,3039,-2931
an4.188,0.17328699461287567,213,9,2742,-2733
an4.189,4.376269051586945e-05,72,73,3005,-2932
an4.19,4.376269051586945e-05,59,80,3435,-3355
an4.190,0.5098837577643289,321,206,1840,-1634
an4.191,0.28411503090246537,652,36,2543,-2507
an4.192,0.2769640475598356,823,74,2467,-2393
an4.193,0.5036487991732175,827,84,1758,-1674
an4.194,0.4184649849801936,301,41,1990,-1949
an4.195,0.5901752416106465,732,51,1619,-1568
an4.196,0.4775258577876196,498,52,1732,-1680
an4.197,0.3340858709325323,618,69,2245,-2176
an4.198,0.8908160952759481,1125,228,1089,-861
an4.199,0.07804819830083964,254,59,3195,-3136
an4.2,4.376269051586945e-05,114,76,3431,-3355
an4.20,0.129266239081538,122,194,2854,-2660
an4.200,0.15685251156198898,948,86,2795,-2709
an4.201,0.1307394990133659,173,152,2906,-2754
an4.202,0.07057510150052515,184,81,3284,-3203
an4.203,0.026698857270934795,213,130,3259,-3129
an4.204,0.039084029538050125,154,131,3132,-3001
an4.205,0.05466179498481161,202,83,3415,-3332
an4.206,0.033405289032173435,124,150,3083,-2933
an4.207,4.376269053807391e-05,109,175,3069,-2894
an4.208,4.376269053807391e-05,124,143,3159,-3016
an4.209,0.06843255718109731,109,175,2959,-2784
an4.21,0.3571615028065356,396,81,2176,-2095
an4.210,0.13159342647723893,135,111,2911,-2800
an4.211,4.376269049366499e-05,59,85,3568,-3483
an4.212,4.376269049366499e-05,45,264,3652,-3388
an4.213,4.376269051586945e-05,47,260,3672,-3412
an4.214,4.376269049366499e-05,26,115,4056,-3941
an4.215,4.376269049366499e-05,22,28,4281,-4253
an4.216,4.376269049366499e-05,22,36,4237,-4201
an4.217,4.376269049366499e-05,30,7,4367,-4360
an4.218,4.376269051586945e-05,30,12,4344,-4332
an4.219,4.376269049366499e-05,22,49,4190,-4141
an4.22,0.7295847464913185,274,157,1218,-1061
an4.220,4.376269049366499e-05,66,271,3304,-3033
an4.221,4.376269049366499e-05,30,64,3907,-3843
an4.222,4.376269049366499e-05,89,189,3627,-3438
an4.223,4.376269049366499e-05,36,101,3592,-3491
an4.224,4.376269049366499e-05,29,115,4056,-3941
an4.225,4.376269049366499e-05,25,28,4281,-4253
an4.226,4.376269049366499e-05,25,36,4237,-4201
an4.227,4.376269049366499e-05,34,9,4339,-4330
an4.228,4.376269051586945e-05,33,12,4344,-4332
an4.229,4.376269049366499e-05,25,49,4190,-4141
an4.23,0.2981952138366495,177,133,2319,-2186
an4.230,4.376269051586945e-05,42,159,3646,-3487
an4.231,4.376269049366499e-05,25,120,3274,-3154
an4.232,4.376269051586945e-05,42,120,3469,-3349
an4.233,0.29166137260108194,262,51,2471,-2420
an4.234,0.39287136295362846,322,100,2077,-1977
an4.235,0.17329447213667581,137,155,2716,-2561
an4.236,0.1480020534216031,161,145,2848,-2703
an4.237,0.1065557041901366,119,109,2949,-2840
an4.238,0.216745939180929,95,251,2599,-2348
an4.239,4.376269049366499e-05,53,238,3794,-3556
an4.24,0.09284939413147786,222,42,3037,-2995
an4.240,4.376269049366499e-05,53,235,3787,-3552
an4.241,0.3133969901721212,129,91,2400,-2309
an4.242,4.376269049366499e-05,36,114,3528,-3414
an4.243,0.22503971356861996,254,80,2709,-2629
an4.244,0.23515988666944487,459,16,2705,-2689
an4.245,0.27312695487429206,242,92,2381,-2289
an4.246,0.09433835619960806,124,44,2899,-2855
an4.247,4.376269051586945e-05,20,48,3368,-3320
an4.248,0.24487880762071867,17,342,2460,-2118
an4.249,0.36608366109820434,19,248,2159,-1911
an4.25,4.376269049366499e-05,47,35,3080,-3045
an4.250,4.376269049366499e-05,17,126,3669,-3543
an4.251,4.376269051586945e-05,17,126,3670,-3544
an4.252,4.376269049366499e-05,17,126,3646,-3520
an4.253,4.376269049366499e-05,27,87,3608,-3521
an4.254,4.376269051586945e-05,83,330,2770,-2440
an4.255,0.09314780522158284,91,99,3002,-2903
an4.256,4.376269049366499e-05,13,63,3861,-3798
an4.257,0.547563644006055,199,118,1694,-1576
an4.258,4.376269051586945e-05,99,68,3265,-3197
an4.259,0.4225782385119281,176,251,2076,-1825
an4.26,4.376269051586945e-05,83,31,3323,-3292
an4.260,0.3266607765952445,172,237,2275,-2038
an4.261,4.376269049366499e-05,13,114,3964,-3850
an4.262,4.376269049366499e-05,59,187,3452,-3265
an4.263,4.376269051586945e-05,106,177,3547,-3370
an4.264,4.376269049366499e-05,71,270,3630,-3360
an4.265,4.376269049366499e-05,52,153,3714,-3561
an4.266,4.376269049366499e-05,45,118,3808,-3690
an4.267,4.376269049366499e-05,44,83,3863,-3780
an4.268,4.376269049366499e-05,49,85,3621,-3536
an4.269,4.376269049366499e-05,50,84,3744,-3660
an4.27,4.376269051586945e-05,85,14,3684,-3670
an4.270,4.376269051586945e-05,44,84,3860,-3776
an4.271,4.376269049366499e-05,39,63,3998,-3935
an4.272,4.376269049366499e-05,38,67,3883,-3816
an4.273,4.376269049366499e-05,44,137,3757,-3620
an4.274,0.2926478922686604,44,345,2305,-1960
an4.275,0.0714177520176218,63,268,2961,-2693
an4.276,0.3032491811248539,32,454,2255,-1801
an4.277-303,4.376269049366499e-05,27,190,3444,-3254
an4.28,0.31900724265145897,314,16,2290,-2274
an4.29,4.376269049366499e-05,110,7,3938,-3931
an4.3,4.376269051586945e-05,173,138,3222,-3084
an4.30,0.28685505987453563,438,34,2404,-2370
an4.304,4.376269051586945e-05,59,155,3398,-3243
an4.31,4.376269049366499e-05,54,40,3336,-3296
an4.32,0.04160179394963048,55,31,3362,-3331
an4.33,0.379335098556699,211,63,2116,-2053
an4.34,0.2764275463704058,185,43,2440,-2397
an4.35,0.30808255957195385,428,172,2324,-2152
an4.36,0.20157477229281184,286,111,2714,-2603
an4.37,0.5497264923991052,271,165,1722,-1557
an4.38,0.557224691445124,185,125,1755,-1630
an4.39,0.09022746770575019,179,57,2941,-2884
an4.4,4.376269051586945e-05,250,45,3616,-3571
an4.40,0.12890648861583198,178,56,2919,-2863
an4.41,0.3017429880468159,225,171,2342,-2171
an4.42,0.08485791861490011,62,38,2891,-2853
an4.43,0.11074041951879554,72,74,2959,-2885
an4.44,0.07578240996324315,60,17,3200,-3183
an4.45,0.28160315256118285,282,54,2365,-2311
an4.46,0.26712075444155214,304,61,2412,-2351
an4.47,4.376269049366499e-05,84,42,3026,-2984
an4.48,0.13098405759237597,136,50,2744,-2694
an4.49,0.092971008853171,123,37,3320,-3283
an4.5,0.4990548231793346,188,163,1850,-1687
an4.50,0.1290664094542482,267,19,3344,-3325
an4.51,0.21786076107841446,238,40,2763,-2723
an4.52,0.3025370923992021,207,121,2313,-2192
an4.53,0.28268795835295624,345,86,2448,-2362
an4.54,0.193253789393788,311,94,2738,-2644
an4.55,0.17918738482880503,160,47,2600,-2553
an4.56,0.03308744324328483,54,23,3254,-3231
an4.57,0.22178525901459523,145,151,2515,-2364
an4.58,0.19815334434876153,95,214,2584,-2370
an4.59,4.376269051586945e-05,77,168,3189,-3021
an4.6,0.1735667179483924,234,88,2774,-2686
an4.60,0.4449857502956345,93,140,1995,-1855
an4.61,0.5993956079066942,660,104,1406,-1302
an4.62,0.4163741113504704,194,106,2043,-1937
an4.63,4.376269049366499e-05,106,28,3369,-3341
an4.64,4.376269049366499e-05,34,243,3176,-2933
an4.65,0.08720596039617501,65,37,2913,-2876
an4.66,4.376269051586945e-05,44,62,3099,-3037
an4.67,0.27014765889377124,201,37,2531,-2494
an4.68,0.05814568778255147,116,96,3337,-3241
an4.69,0.3120043262825556,121,226,2353,-2127
an4.7,0.28409430355640364,100,64,2482,-2418
an4.70,0.18806843658134564,267,31,2726,-2695
an4.71,4.376269051586945e-05,43,304,3237,-2933
an4.72,4.376269049366499e-05,35,246,3060,-2814
an4.73,0.17555124345354223,373,69,2607,-2538
an4.74,4.376269049366499e-05,13,44,4015,-3971
an4.75,4.376269049366499e-05,13,46,4012,-3966
an4.76,0.2612280758180541,239,85,2456,-2371
an4.77,4.376269049366499e-05,72,18,4074,-4056
an4.78,4.376269053807391e-05,143,9,3615,-3606
an4.79,0.10373504219143292,251,284,2845,-2561
an4.8,0.36379193923332664,214,69,2147,-2078
an4.80,0.2878574472759965,81,157,2334,-2177
an4.81,4.376269049366499e-05,57,294,3617,-3323
an4.82,4.376269049366499e-05,59,289,3542,-3253
an4.83,4.376269049366499e-05,81,166,3781,-3615
an4.84,4.376269049366499e-05,69,166,3846,-3680
an4.85,0.21217683100362983,350,371,2626,-2255
an4.86,4.376269049366499e-05,21,195,3569,-3374
an4.87,0.3041791196220389,380,102,2309,-2207
an4.88,0.2274693375622805,119,187,2548,-2361
an4.89,0.16704233596993578,150,119,2779,-2660
an4.9,0.1029949679802522,64,142,2974,-2832
an4.90,0.3764196759062255,185,214,2127,-1913
an4.91,4.376269051586945e-05,120,95,3275,-3180
an4.92,0.10965161805631674,67,134,2844,-2710
an4.93,0.19606987370448525,239,97,2788,-2691
an4.94,0.25563537559532,311,122,2443,-2321
an4.95,0.0909120217293724,149,111,3102,-2991
an4.96,4.376269053807391e-05,214,131,3334,-3203
an4.97,0.2531765859404844,275,148,2443,-2295
an4.98,4.376269049366499e-05,33,83,3572,-3489
an4.99,0.0746827743399292,242,167,2978,-2811
an5.1,0.15696759062473475,73,78,2832,-2754
an5.10,4.376269051586945e-05,176,118,3729,-3611
an5.100,0.39800864004306824,730,57,2068,-2011
an5.101,0.03227917734440755,85,21,3520,-3499
an5.102,4.376269051586945e-05,40,161,3394,-3233
an5.103,0.1730639758687369,398,59,2878,-2819
an5.104,0.20385628914016962,252,50,2664,-2614
an5.105,0.15690980119029696,71,27,2738,-2711
an5.106,0.18163027310780233,259,118,2621,-2503
an5.107,4.376269051586945e-05,41,314,3140,-2826
an5.108,0.03617054195479419,54,296,3354,-3058
an5.109,0.6777947773821902,81,335,1485,-1150
an5.11,4.376269051586945e-05,46,100,3076,-2976
an5.110,0.2063775755166919,80,272,2486,-2214
an5.111,4.376269051586945e-05,98,184,3496,-3312
an5.112,4.376269049366499e-05,71,202,3561,-3359
an5.113,4.376269051586945e-05,71,250,3440,-3190
an5.114,0.26474199171924173,128,67,2534,-2467
an5.115,4.376269049366499e-05,68,124,3807,-3683
an5.116,4.376269049366499e-05,92,142,3793,-3651
an5.117,4.376269049366499e-05,78,177,3776,-3599
an5.118,4.376269049366499e-05,78,177,3768,-3591
an5.119,4.376269049366499e-05,78,177,3758,-3581
an5.12,4.376269051586945e-05,72,129,3122,-2993
an5.120,4.376269049366499e-05,85,169,3622,-3453
an5.121,0.30596061154253285,97,115,2280,-2165
an5.122,0.4501209349753399,76,303,2068,-1765
an5.123,4.376269051586945e-05,107,182,3323,-3141
an5.124,4.376269049366499e-05,114,145,3625,-3480
an5.125,4.376269051586945e-05,50,193,3045,-2852
an5.126,4.376269049366499e-05,48,205,2979,-2774
an5.127,0.07748842265011824,83,175,3356,-3181
an5.128,4.376269053807391e-05,65,46,3337,-3291
an5.129,4.376269049366499e-05,37,19,3628,-3609
an5.13,4.376269049366499e-05,14,221,3772,-3551
an5.130,0.27184513730487136,101,472,2341,-1869
an5.131,4.376269051586945e-05,122,179,3411,-3232
an5.132,4.376269051586945e-05,130,151,3553,-3402
an5.133,0.11781382457367595,308,36,2874,-2838
an5.134,0.6251914499342259,198,174,1455,-1281
an5.135,0.2900416403385675,337,164,2325,-2161
an5.136,0.354461557358543,296,179,2188,-2009
an5.137,4.376269051586945e-05,59,16,3698,-3682
an5.138,4.376269051586945e-05,109,119,3630,-3511
an5.139,0.1700669463295501,861,156,2909,-2753
an5.14,0.9032537297511967,175,433,1313,-880
an5.140,0.40897188227717596,479,190,2020,-1830
an5.141,0.2168020457738784,152,122,2628,-2506
an5.142,0.23076748117512036,327,149,2646,-2497
an5.143,0.23104805548206375,254,44,2528,-2484
an5.144,0.021897394558800798,229,73,3225,-3152
an5.145,4.376269049366499e-05,64,310,3338,-3028
an5.146,4.376269051586945e-05,85,215,3580,-3365
an5.147,4.376269049366499e-05,39,338,3492,-3154
an5.148,0.12359642545736182,166,167,3010,-2843
an5.149,4.376269051586945e-05,54,146,2979,-2833
an5.15,4.376269049366499e-05,65,102,3679,-3577
an5.150,4.376269051586945e-05,66,134,3049,-2915
an5.151,4.376269049366499e-05,86,206,3225,-3019
an5.152,4.376269049366499e-05,85,193,3529,-3336
an5.153,4.376269051586945e-05,96,220,2884,-2664
an5.154,0.1728032067128904,86,95,2694,-2599
an5.155,0.2458057284630666,228,111,2442,-2331
an5.156,0.3257318749886773,377,100,2313,-2213
an5.157,4.376269051586945e-05,441,6,3550,-3544
an5.158,4.376269051586945e-05,63,304,3503,-3199
an5.159,0.27789567047524777,131,121,2356,-2235
an5.16,4.376269051586945e-05,52,162,3308,-3146
an5.160,4.376269051586945e-05,34,23,3420,-3397
an5.161,4.376269049366499e-05,108,21,3673,-3652
an5.162,0.289146056293732,606,70,2350,-2280
an5.163,0.09003311886077725,88,233,2574,-2341
an5.164,0.054580277103855046,79,223,2733,-2510
an5.165,0.06549653065945904,107,76,2883,-2807
an5.166,0.669719717617423,623,296,1646,-1350
an5.167,0.2524294070017419,613,131,2698,-2567
an5.168,0.16908122546284154,134,153,2513,-2360
an5.169,0.14278375456735493,119,222,2690,-2468
an5.17,0.02130025976951888,62,274,2831,-2557
an5.170,0.3355373788122451,198,65,2237,-2172
an5.171,0.1935629160615404,86,338,2642,-2304
an5.172,4.376269051586945e-05,55,301,3420,-3119
an5.173,4.376269049366499e-05,59,298,3399,-3101
an5.174,0.4878239749935398,215,159,1914,-1755
an5.175,4.376269051586945e-05,85,159,3371,-3212
an5.176,0.21887705903529397,246,110,2596,-2486
an5.177,4.376269049366499e-05,18,38,3837,-3799
an5.178,0.13806209163693683,553,55,2750,-2695
an5.179,0.5353455894168135,394,188,1762,-1574
an5.18,0.02164578151251373,62,291,2815,-2524
an5.180,0.4261206000651052,726,125,2037,-1912
an5.181,4.376269051586945e-05,120,59,3542,-3483
an5.182,4.376269051586945e-05,21,106,3556,-3450
an5.183,4.376269051586945e-05,21,84,3586,-3502
an5.184,4.376269049366499e-05,21,82,3593,-3511
an5.185,4.376269049366499e-05,6,41,4259,-4218
an5.186,4.376269051586945e-05,6,39,4261,-4222
an5.187,4.376269051586945e-05,6,65,3903,-3838
an5.188,4.376269049366499e-05,6,41,4259,-4218
an5.189,4.376269049366499e-05,6,36,3794,-3758
an5.19,0.053830950083888496,69,297,2703,-2406
an5.190,0.06204817164661147,129,49,3261,-3212
an5.191,4.376269051586945e-05,208,29,3822,-3793
an5.192,0.4278304592618243,1173,95,1957,-1862
an5.193,0.3668223844812024,867,213,2079,-1866
an5.194,0.39034792246495087,363,128,2088,-1960
an5.195,0.3348916594835494,164,60,2227,-2167
an5.196,0.08187517325832783,388,51,3082,-3031
an5.197,0.03650279863320893,139,16,3453,-3437
an5.198,4.376269049366499e-05,52,103,3885,-3782
an5.199,0.017282890073255786,126,59,3402,-3343
an5.2,0.48993132772383596,144,227,1826,-1599
an5.20,0.048415641631804895,73,226,2954,-2728
an5.200,0.19110370719854775,315,52,2702,-2650
an5.201,0.15199975736412963,131,56,2777,-2721
an5.202,4.376269051586945e-05,23,90,3420,-3330
an5.203,4.376269049366499e-05,70,233,3625,-3392
an5.204,4.376269049366499e-05,14,208,3780,-3572
an5.205,0.05707883554846305,101,15,3202,-3187
an5.206,0.2051197434055796,139,29,2658,-2629
an5.207,4.376269049366499e-05,22,77,3705,-3628
an5.208,4.376269049366499e-05,54,79,3668,-3589
an5.209,4.376269051586945e-05,45,45,3253,-3208
an5.21,4.376269049366499e-05,84,41,3398,-3357
an5.210,4.376269051586945e-05,70,69,3126,-3057
an5.211,0.24485697582496968,50,267,2369,-2102
an5.212,0.13000508862710536,50,166,2596,-2430
an5.213,0.15688111012770456,190,94,2705,-2611
an5.214,4.376269049366499e-05,64,261,3191,-2930
an5.215,4.376269051586945e-05,66,447,2919,-2472
an5.216,4.376269051586945e-05,66,457,2885,-2428
an5.217,4.376269053807391e-05,65,426,2895,-2469
an5.218,4.376269051586945e-05,52,102,3478,-3376
an5.219,4.376269049366499e-05,18,99,3421,-3322
an5.22,4.376269049366499e-05,84,48,3346,-3298
an5.220,4.376269049366499e-05,26,90,3307,-3217
an5.221,4.376269051586945e-05,59,93,3381,-3288
an5.222,4.376269049366499e-05,58,89,3469,-3380
an5.223,4.376269049366499e-05,74,48,3406,-3358
an5.224,4.376269051586945e-05,48,120,3567,-3447
an5.225,0.03812164655425665,28,82,3193,-3111
an5.226,4.376269051586945e-05,48,76,3145,-3069
an5.227,0.10842539435829135,68,85,2854,-2769
an5.228,0.12865264359771533,96,68,2712,-2644
an5.229,4.376269051586945e-05,35,110,3558,-3448
an5.23,0.5056443332804195,566,108,1716,-1608
an5.230,4.376269049366499e-05,66,116,3295,-3179
an5.231,4.376269049366499e-05,79,224,3294,-3070
an5.232,0.5379135062978824,103,291,1708,-1417
an5.233,4.376269051586945e-05,62,238,3119,-2881
an5.234,4.376269049366499e-05,69,197,2808,-2611
an5.235,4.376269049366499e-05,69,157,3160,-3003
an5.236,4.376269049366499e-05,96,180,3770,-3590
an5.237,4.376269049366499e-05,88,218,3759,-3541
an5.238,4.376269049366499e-05,82,232,3751,-3519
an5.239,4.376269049366499e-05,72,231,3799,-3568
an5.24,0.05982228802319245,137,123,2699,-2576
an5.240,4.376269051586945e-05,84,220,3602,-3382
an5.241,4.376269051586945e-05,65,426,2895,-2469
an5.242,4.376269049366499e-05,12,45,4255,-4210
an5.243,4.376269049366499e-05,12,45,4255,-4210
an5.244,4.376269051586945e-05,38,276,2967,-2691
an5.245,4.376269051586945e-05,50,125,3465,-3340
an5.246,4.376269049366499e-05,12,45,4255,-4210
an5.247,4.376269049366499e-05,12,45,4255,-4210
an5.248,4.376269049366499e-05,31,88,3534,-3446
an5.249,0.20935209284336231,182,61,2694,-2633
an5.25,4.376269051586945e-05,51,76,3629,-3553
an5.250,0.06611836894470091,182,76,2937,-2861
an5.251,0.03191346375166493,39,238,3365,-3127
an5.252,4.376269051586945e-05,29,246,3331,-3085
an5.253,0.028029607414192803,38,169,3407,-3238
an5.254,4.376269049366499e-05,23,47,3616,-3569
an5.255,4.376269049366499e-05,34,117,3675,-3558
an5.256,4.376269051586945e-05,53,86,3206,-3120
an5.257-263,4.376269049366499e-05,91,113,3276,-3163
an5.26,0.4282860473478145,496,168,2019,-1851
an5.264,4.376269049366499e-05,55,103,3202,-3099
an5.265-271,4.376269051586945e-05,77,109,3220,-3111
an5.27,0.06790807700098878,77,42,3044,-3002
an5.272,4.376269051586945e-05,123,245,3551,-3306
an5.273-285,4.376269051586945e-05,270,47,3710,-3663
an5.28,0.5554577731151422,799,124,1786,-1662
an5.286,4.376269051586945e-05,68,305,3400,-3095
an5.287-292,4.376269049366499e-05,80,210,3396,-3186
an5.29,4.376269049366499e-05,29,89,3420,-3331
an5.293,4.376269049366499e-05,32,249,3480,-3231
an5.294-302,4.376269049366499e-05,47,215,3496,-3281
an5.3,0.1917944078160927,109,602,2521,-1919
an5.30,0.437640399525141,320,78,1884,-1806
an5.303,4.376269051586945e-05,22,285,3030,-2745
an5.308-1152,0.18535037085956052,120,238,2712,-2474
an5.31,0.3510404715379112,363,68,2203,-2135
an5.32,0.4532373526773936,330,240,1818,-1578
an5.33,0.4355250279394207,312,22,1970,-1948
an5.34,0.16826163191570043,331,78,2714,-2636
an5.35,0.1935720478303926,55,189,2475,-2286
an5.36,4.376269053807391e-05,66,188,2925,-2737
an5.37,4.376269049366499e-05,96,138,3315,-3177
an5.38,0.28920497594837613,122,37,2441,-2404
an5.39,4.376269051586945e-05,92,6,3643,-3637
an5.4,4.376269051586945e-05,69,274,3601,-3327
an5.40,0.09621629500176088,112,97,3355,-3258
an5.41,0.35471253622068044,272,63,2184,-2121
an5.42,0.04787310699996272,109,47,3728,-3681
an5.43,0.38357938186261986,294,112,2108,-1996
an5.44,0.23809012370812344,342,29,2611,-2582
an5.45,0.19614032167460937,215,41,2676,-2635
an5.46,4.376269049366499e-05,14,100,3713,-3613
an5.47,0.4479221282538193,137,188,1968,-1780
an5.48,0.09349314528341868,487,15,3090,-3075
an5.49,0.2500811253437929,113,55,2398,-2343
an5.5,0.14069042732691717,157,83,2585,-2502
an5.50,0.388512632028748,988,41,2090,-2049
an5.51,0.1712578922135055,270,40,2847,-2807
an5.52,4.376269051586945e-05,38,126,3344,-3218
an5.53,0.5049831575300257,75,267,1913,-1646
an5.54,0.16900539654536306,226,56,2726,-2670
an5.55,0.3596994531877007,315,46,2172,-2126
an5.56,0.7195955590330039,384,139,1626,-1487
an5.57,0.20922295566820903,732,37,2727,-2690
an5.58,0.42675805148477686,426,45,1874,-1829
an5.59,4.376269049366499e-05,28,130,3847,-3717
an5.6,4.376269051586945e-05,126,16,3770,-3754
an5.60,4.376269049366499e-05,38,109,3799,-3690
an5.61,4.376269051586945e-05,30,138,3014,-2876
an5.62,4.376269051586945e-05,30,141,3008,-2867
an5.63,4.376269053807391e-05,56,60,3545,-3485
an5.64,4.376269051586945e-05,56,59,3646,-3587
an5.65,4.376269051586945e-05,76,189,3219,-3030
an5.66,0.026936773084340615,76,212,3096,-2884
an5.67,0.49330090535777416,73,337,2008,-1671
an5.68,0.4672501896627823,93,180,2038,-1858
an5.69,0.1334548756715348,47,254,2756,-2502
an5.7,0.15079100507284782,209,46,2912,-2866
an5.70,0.24931261218823497,52,243,2377,-2134
an5.71,0.4517301508489391,190,102,2005,-1903
an5.72,0.3534321945650065,178,91,2194,-2103
an5.73,0.2566710642564196,212,34,2521,-2487
an5.74,0.26836028762973196,185,66,2372,-2306
an5.75,0.2937197132700353,824,63,2356,-2293
an5.76,0.329451726955754,1237,86,2326,-2240
an5.77,0.02602622710632385,355,36,3190,-3154
an5.78,0.17324804672227412,482,36,2741,-2705
an5.79,0.17832643120805347,392,12,2813,-2801
an5.8,4.376269049366499e-05,106,96,3893,-3797
an5.80,0.3124303406363049,260,26,2300,-2274
an5.81,4.376269049366499e-05,95,202,3725,-3523
an5.82,4.376269049366499e-05,89,232,3693,-3461
an5.83,4.376269049366499e-05,101,215,3708,-3493
an5.84,4.376269049366499e-05,89,246,3654,-3408
an5.85,4.376269051586945e-05,91,205,3717,-3512
an5.86,4.376269051586945e-05,59,219,2939,-2720
an5.87,0.5432993441244482,103,294,1700,-1406
an5.88,0.19353419010366135,225,132,2626,-2494
an5.89,4.376269051586945e-05,52,176,2917,-2741
an5.9,4.376269049366499e-05,134,92,3902,-3810
an5.90,0.11003547629788724,304,92,2975,-2883
an5.91,4.376269049366499e-05,14,100,3713,-3613
an5.92,4.376269051586945e-05,14,143,3399,-3256
an5.93,4.376269049366499e-05,28,67,3792,-3725
an5.94,0.23265557591669594,53,297,2418,-2121
an5.95,0.06514959098977702,34,236,2979,-2743
an5.96,0.21994844891375376,70,187,2477,-2290
an5.97,0.06574519151780756,59,186,3010,-2824
an5.98,4.376269051586945e-05,47,188,3252,-3064
an5.99,4.376269049366499e-05,159,197,3369,-3172
an6.1,0.44109526621141093,104,262,2047,-1785
an6.10,0.4695510782386503,682,183,1883,-1700
an6.100,4.376269049366499e-05,19,32,3873,-3841
an6.101,4.376269051586945e-05,68,88,2985,-2897
an6.102,4.376269051586945e-05,55,73,2915,-2842
an6.103,4.376269053807391e-05,58,89,3107,-3018
an6.104,0.09004687205349526,51,46,3138,-3092
an6.105,0.043557328616961044,53,48,3248,-3200
an6.106,0.14981528345419104,64,172,2807,-2635
an6.107,4.376269051586945e-05,46,272,2940,-2668
an6.108,4.376269051586945e-05,46,241,3043,-2802
an6.109,4.376269051586945e-05,46,265,2772,-2507
an6.11,0.24002561034803804,131,105,2549,-2444
an6.110,4.376269051586945e-05,46,256,3100,-2844
an6.111,4.376269051586945e-05,46,254,3110,-2856
an6.112,4.376269051586945e-05,46,270,2977,-2707
an6.113,4.376269051586945e-05,46,259,3023,-2764
an6.114,4.376269051586945e-05,46,261,3084,-2823
an6.115,4.376269051586945e-05,48,260,3036,-2776
an6.116,4.376269051586945e-05,54,252,2731,-2479
an6.117,4.376269049366499e-05,55,173,3230,-3057
an6.118,4.376269051586945e-05,85,205,3038,-2833
an6.119,4.376269049366499e-05,40,173,3561,-3388
an6.12,0.17048718894858705,171,33,2858,-2825
an6.120-139,4.376269051586945e-05,101,136,3659,-3523
an6.13,0.3670218012461701,447,156,2169,-2013
an6.14,0.02195199703176609,231,50,3281,-3231
an6.140,0.09032550979533038,21,141,2912,-2771
an6.141,4.376269051586945e-05,21,282,3227,-2945
an6.142,4.376269051586945e-05,23,299,3200,-2901
an6.143-169,4.376269049366499e-05,24,205,3469,-3264
an6.15,4.376269051586945e-05,177,37,3427,-3390
an6.16,0.14742438787243017,522,75,3016,-2941
an6.17,0.44047715435600043,418,56,1999,-1943
an6.170,4.376269051586945e-05,70,154,3143,-2989
an6.18,0.13423336101034966,406,5,2902,-2897
an6.19,0.34837170828627695,485,11,2196,-2185
an6.2,0.4937825586575073,279,311,1895,-1584
an6.20,0.5418596750056626,448,111,1818,-1707
an6.21,0.6808236954503055,220,209,1371,-1162
an6.22,0.18010684661307064,81,157,2795,-2638
an6.23,4.376269051586945e-05,100,27,3527,-3500
an6.24,0.040286291340319025,51,106,3187,-3081
an6.25,0.28950228875610495,375,189,2327,-2138
an6.26,0.41936122000278964,552,374,2049,-1675
an6.27,0.4997864571386179,403,150,1996,-1846
an6.28,0.48874814019532753,446,164,1831,-1667
an6.29,0.4217944112540062,429,72,1996,-1924
an6.3,4.376269051586945e-05,47,240,3214,-2974
an6.30,0.4616799611239175,658,69,1825,-1756
an6.31,4.376269051586945e-05,53,124,3120,-2996
an6.32,0.5727147089785944,139,173,1743,-1570
an6.33,0.4150879331071611,69,150,2039,-1889
an6.34,0.29559495850617346,394,278,2322,-2044
an6.35,4.376269051586945e-05,19,102,3256,-3154
an6.36,0.2072327580048272,250,18,2681,-2663
an6.37,0.278532675985832,239,86,2445,-2359
an6.38,0.06667862646267952,149,142,2814,-2672
an6.39,4.376269051586945e-05,191,12,3803,-3791
an6.4,4.376269051586945e-05,47,257,3291,-3034
an6.40,0.13706574135865512,143,50,2878,-2828
an6.41,4.376269051586945e-05,106,80,3137,-3057
an6.42,0.3576872711302137,452,43,2181,-2138
an6.43,0.461320726785619,412,152,1961,-1809
an6.44,0.5487619856051618,731,114,1778,-1664
an6.45,0.53497600675525,448,80,1761,-1681
an6.46,0.3770573999474225,244,133,2054,-1921
an6.47,0.08825971608408256,206,78,3040,-2962
an6.48,0.1412761314090849,210,187,2869,-2682
an6.49,0.33562128339357233,190,113,2217,-2104
an6.5,4.376269053807391e-05,97,110,3583,-3473
an6.50,0.15211053300940858,125,129,2586,-2457
an6.51,0.3922484260552528,280,208,2027,-1819
an6.52,0.12312314417530779,185,126,3089,-2963
an6.53,0.2868375908286591,265,180,2351,-2171
an6.54,0.6743210848666914,1298,80,1403,-1323
an6.55,0.6263501591509568,789,84,1404,-1320
an6.56,0.5171872186000126,670,186,1710,-1524
an6.57,0.3713701947176462,652,216,2143,-1927
an6.58,0.5653741307294124,543,168,1698,-1530
an6.59,0.16784837691725674,289,94,2961,-2867
an6.6,4.376269049366499e-05,92,154,3495,-3341
an6.60,0.6117313715096495,1044,284,1518,-1234
an6.61,0.38402615472092894,459,130,2113,-1983
an6.62,0.5468263800014528,1336,187,1690,-1503
an6.63,0.4417532484809694,1113,278,2001,-1723
an6.64,0.32391950447692164,590,231,2259,-2028
an6.65,4.376269051586945e-05,45,159,3312,-3153
an6.66,4.376269049366499e-05,45,156,3273,-3117
an6.67,4.376269051586945e-05,93,47,3399,-3352
an6.68,4.376269049366499e-05,111,62,3707,-3645
an6.69,0.5076990016173788,315,178,1869,-1691
an6.7,4.376269049366499e-05,93,154,3493,-3339
an6.70,0.15220756048115458,228,108,2939,-2831
an6.71,0.1735597036861769,115,326,2379,-2053
an6.72,4.376269049366499e-05,84,224,3560,-3336
an6.73,4.376269051586945e-05,71,273,2810,-2537
an6.74,0.0921407445756861,61,230,2679,-2449
an6.75,0.2499536890201437,89,515,2347,-1832
an6.76,4.376269051586945e-05,47,154,3316,-3162
an6.77,4.376269049366499e-05,59,84,3353,-3269
an6.78,0.10937957031138534,49,193,2904,-2711
an6.79,0.05081605071388662,129,144,3189,-3045
an6.8,4.376269049366499e-05,16,34,3322,-3288
an6.80,4.376269051586945e-05,43,176,3472,-3296
an6.81,4.376269049366499e-05,67,263,3561,-3298
an6.82,4.376269049366499e-05,67,259,3633,-3374
an6.83,4.376269051586945e-05,85,231,3246,-3015
an6.84,0.1137803182918562,123,126,2634,-2508
an6.85,0.023332347255111685,127,186,3254,-3068
an6.86,4.376269051586945e-05,90,255,3168,-2913
an6.87,4.376269049366499e-05,110,144,3517,-3373
an6.88,4.376269051586945e-05,92,208,3198,-2990
an6.89,4.376269051586945e-05,53,63,3273,-3210
an6.9,4.376269049366499e-05,16,42,3854,-3812
an6.90,4.376269049366499e-05,25,115,2965,-2850
an6.91,4.376269051586945e-05,27,96,3245,-3149
an6.92,4.376269049366499e-05,50,106,3711,-3605
an6.93,4.376269049366499e-05,50,106,3614,-3508
an6.94,4.376269049366499e-05,47,102,3675,-3573
an6.95,0.05182996997148415,73,88,3295,-3207
an6.96,4.376269051586945e-05,43,64,3452,-3388
an6.97,0.31390125448205186,29,141,2368,-2227
an6.98,4.376269051586945e-05,69,86,3004,-2918
an6.99,4.376269049366499e-05,19,25,4175,-4150
an7.1,0.1811799583676832,136,211,2858,-2647
an7.10,4.376269051586945e-05,27,127,2783,-2656
an7.11,4.376269051586945e-05,17,76,3735,-3659
an7.12,4.376269051586945e-05,84,49,3291,-3242
an7.13,4.376269049366499e-05,101,34,4001,-3967
an7.14,4.376269049366499e-05,31,86,3628,-3542
an7.15,0.28235994817389365,435,123,2363,-2240
an7.16,0.2828581878366876,148,195,2352,-2157
an7.17,0.20149496533377054,22,216,2619,-2403
an7.18,4.376269049366499e-05,7,29,3644,-3615
an7.19,0.1989041073769071,131,149,2518,-2369
an7.2,4.376269051586945e-05,112,202,3658,-3456
an7.20,0.048120568214327086,66,7,3365,-3358
an7.21,0.1634677149856989,222,22,3228,-3206
an7.22,0.28956253892535866,666,77,2409,-2332
an7.23,0.20119046581077438,189,71,2821,-2750
an7.24,0.05302328600182982,100,115,3004,-2889
an7.25,0.036267240447585,78,119,3020,-2901
an7.26,0.13030984420943081,78,189,2815,-2626
an7.27,4.376269051586945e-05,78,82,3212,-3130
an7.28,0.30229350426493884,123,140,2281,-2141
an7.29,0.236750879150871,175,106,2575,-2469
an7.3,0.18221903876325385,58,130,2680,-2550
an7.30,4.376269049366499e-05,14,11,4345,-4334
an7.31,0.14151503791368647,138,62,2974,-2912
an7.32,0.5568437318814956,145,169,1797,-1628
an7.33,0.3844282614440031,74,155,2130,-1975
an7.34,0.21918660357191921,59,138,2488,-2350
an7.35,0.23275176073804804,240,111,2505,-2394
an7.36,4.376269049366499e-05,59,32,3850,-3818
an7.37,4.376269051586945e-05,70,52,3542,-3490
an7.38,0.1418971969450622,97,114,2673,-2559
an7.39,0.19786967370785113,90,190,2458,-2268
an7.4,0.5800051673009232,191,251,1704,-1453
an7.40,0.03882465828779491,55,120,3268,-3148
an7.41,0.041058309965325,50,116,3185,-3069
an7.42,0.5522684106906706,334,106,1775,-1669
an7.43,0.6779192603280748,318,166,1572,-1406
an7.44,0.11359843032667793,100,149,2780,-2631
an7.45,4.376269051586945e-05,28,85,2862,-2777
an7.46,4.376269051586945e-05,16,75,3777,-3702
an7.47,0.4591027427391259,785,130,1933,-1803
an7.48,4.376269049366499e-05,34,140,3173,-3033
an7.49,0.30148797319855536,1052,166,2324,-2158
an7.5,4.376269049366499e-05,49,45,3494,-3449
an7.50,0.5293470523942245,418,151,1710,-1559
an7.51,0.07978777046855345,288,32,2899,-2867
an7.52,0.2848793257291815,626,275,2435,-2160
an7.53,0.44747246725347356,639,96,1805,-1709
an7.54,0.2873424635273292,399,452,2325,-1873
an7.55,0.23014673155457022,787,113,2518,-2405
an7.56,0.4961164484143854,719,241,1871,-1630
an7.57,0.22068314404881662,617,64,2501,-2437
an7.58,0.4039550664541869,254,155,2062,-1907
an7.59,0.13063442904637235,150,41,2885,-2844
an7.6,0.5058147152807502,205,194,1687,-1493
an7.60,4.376269051586945e-05,49,305,3273,-2968
an7.61,0.4524594366645207,562,87,1891,-1804
an7.615,4.376269051586945e-05,19,359,2872,-2513
an7.62,0.2953735687100556,197,56,2542,-2486
an7.63,0.3207116655533637,381,29,2255,-2226
an7.64,0.2814624784463371,587,16,2443,-2427
an7.645,4.376269053807391e-05,69,198,3096,-2898
an7.65,0.152814639118648,152,112,2663,-2551
an7.66,0.582337106807862,815,220,1524,-1304
an7.67,0.34296299024763055,911,90,2218,-2128
an7.68,0.37889279760823236,652,153,2112,-1959
an7.69,0.12474808059832476,444,62,3017,-2955
an7.7,0.17242477723644623,134,32,2632,-2600
an7.70,0.22844840498932317,899,40,2621,-2581
an7.71,0.43681668670763063,398,108,2052,-1944
an7.72,0.22068250461135808,1211,161,2514,-2353
an7.73,0.4089034640275102,238,239,2095,-1856
an7.74,0.19762562869349853,500,61,2882,-2821
an7.75,0.24977645217858502,59,250,2407,-2157
an7.76,0.13819332409015228,60,200,2735,-2535
an7.77,0.049700964302812345,54,232,2793,-2561
an7.78,4.376269051586945e-05,63,226,3056,-2830
an7.79,4.376269049366499e-05,49,216,3283,-3067
an7.8,4.376269051586945e-05,17,128,3008,-2880
an7.80,4.376269051586945e-05,52,180,3270,-3090
an7.81,4.376269049366499e-05,46,195,3341,-3146
an7.82,4.376269049366499e-05,57,192,3299,-3107
an7.83,0.5076196517778797,87,149,1968,-1819
an7.84,0.07544985650234093,42,33,2968,-2935
an7.85,4.376269049366499e-05,37,29,3773,-3744
an7.86,4.376269049366499e-05,9,45,4023,-3978
an7.87,4.376269051586945e-05,7,35,4245,-4210
an7.88,4.376269049366499e-05,7,1,4373,-4372
an7.89,4.376269049366499e-05,7,1,4373,-4372
an7.9,0.1582913058123525,85,137,2646,-2509
an7.90,4.376269049366499e-05,7,3,4365,-4362
an7.91,4.376269049366499e-05,7,46,4230,-4184
an7.92,4.376269049366499e-05,34,20,3826,-3806
an7.93,4.376269051586945e-05,24,111,3627,-3516
an7.94,4.376269049366499e-05,35,107,3141,-3034
an7.95,0.29540975198918407,156,192,2316,-2124
an7.96-614,0.3637837716945702,311,110,2162,-2052
an8.1,0.24459282036286556,143,18,2525,-2507
an8.10,0.3423552586022005,450,44,2241,-2197
an8.11,0.7383435455730281,1114,253,1384,-1131
an8.118,4.376269051586945e-05,22,209,3207,-2998
an8.119,4.376269051586945e-05,97,79,3315,-3236
an8.12,0.4212962439883894,1483,107,2013,-1906
an8.120,0.27363713367403175,65,240,2361,-2121
an8.121-147,4.376269049366499e-05,28,197,3411,-3214
an8.13,0.3271760703439819,275,125,2373,-2248
an8.14,0.13652179680978538,685,27,3264,-3237
an8.148,4.376269049366499e-05,62,165,3503,-3338
an8.15,4.376269051586945e-05,75,7,3639,-3632
an8.16,0.07491334646980707,104,138,3442,-3304
an8.17,4.376269051586945e-05,62,25,4000,-3975
an8.18,4.376269051586945e-05,62,16,3870,-3854
an8.19,0.316227009206016,1024,39,2308,-2269
an8.2,0.5715479159416503,621,135,1701,-1566
an8.20,0.4788316467131848,596,65,1802,-1737
an8.21,0.7148879260022944,598,185,1338,-1153
an8.22,0.6622115577952892,670,179,1387,-1208
an8.23,0.19756255074698803,333,79,2452,-2373
an8.24,0.16753627564127793,230,35,2888,-2853
an8.25,0.30258013716510934,256,141,2310,-2169
an8.26,0.31749589100538156,203,122,2284,-2162
an8.27,4.376269051586945e-05,27,53,3520,-3467
an8.28,0.404326991884596,294,110,2086,-1976
an8.29,0.44623512283197275,440,128,2013,-1885
an8.3,4.376269051586945e-05,112,203,3579,-3376
an8.30,0.5516107443848783,1081,226,1687,-1461
an8.31,4.376269051586945e-05,52,218,3430,-3212
an8.32,4.376269051586945e-05,15,75,3458,-3383
an8.33,4.376269051586945e-05,58,277,3189,-2912
an8.34,0.20869361724367153,232,109,2680,-2571
an8.35,0.2012827277667828,359,405,2409,-2004
an8.36,0.060774293972021276,381,50,3307,-3257
an8.37,4.376269051586945e-05,56,227,3080,-2853
an8.38,0.016923893564713133,146,45,3776,-3731
an8.39,0.22190454045623031,275,153,2591,-2438
an8.4,4.376269051586945e-05,113,177,3375,-3198
an8.40,0.16051454067889104,136,55,2794,-2739
an8.41,0.186884194560899,336,69,2723,-2654
an8.42,0.4083707330514885,601,330,2037,-1707
an8.43,0.47638996431875746,465,216,1809,-1593
an8.44,0.12793352580424688,160,127,2919,-2792
an8.45,0.48331849195417664,415,198,1781,-1583
an8.46,0.4561063934933829,660,92,1902,-1810
an8.47,0.38996491114879905,126,333,2104,-1771
an8.48,0.5606296504638175,237,343,1723,-1380
an8.49,0.3058652510625537,358,62,2398,-2336
an8.5,0.1254135703644632,82,60,2607,-2547
an8.50,0.28982692215795414,282,90,2452,-2362
an8.51,0.351930455010363,864,126,2193,-2067
an8.52,0.32367178677550346,121,229,2248,-2019
an8.53,0.24421284703111112,141,51,2637,-2586
an8.54,0.4971039623314466,623,12,1717,-1705
an8.55,0.6650671873281722,608,103,1337,-1234
an8.56,4.376269049366499e-05,129,26,3843,-3817
an8.57,0.21812734944408607,99,292,2471,-2179
an8.58,0.11777089464211077,87,238,2599,-2361
an8.59,4.376269051586945e-05,55,80,3303,-3223
an8.6,0.30984983464048543,428,198,2298,-2100
an8.60,4.376269049366499e-05,67,78,3101,-3023
an8.61,0.10561390900061252,467,28,3121,-3093
an8.62,0.18142693656877373,512,273,2677,-2404
an8.63,0.25856069385656877,425,72,2540,-2468
an8.64,0.19908714724043985,511,84,2620,-2536
an8.65,4.376269051586945e-05,155,44,3285,-3241
an8.66,0.1499327066085243,86,129,2728,-2599
an8.67,4.376269049366499e-05,26,26,3870,-3844
an8.68,4.376269049366499e-05,26,26,3870,-3844
an8.69,0.12542281223422158,173,20,2785,-2765
an8.7,0.06694156884723412,307,40,3639,-3599
an8.70,0.6429276447264209,895,136,1671,-1535
an8.71,0.21278408090086298,257,108,2534,-2426
an8.72,0.3346972743310639,229,99,2282,-2183
an8.73,0.3124297618207761,608,11,2300,-2289
an8.74,0.551065278048557,454,113,1872,-1759
an8.75,0.0602353040367154,50,36,2902,-2866
an8.76,0.4329423376555397,408,59,1893,-1834
an8.77,0.11084219597090605,469,26,3085,-3059
an8.78,0.1697833221709688,480,273,2726,-2453
an8.79,4.376269051586945e-05,58,90,3125,-3035
an8.8,0.2371746982618994,693,44,2592,-2548
an8.80,0.08524509517593426,712,66,2910,-2844
an8.81,0.14131708511937457,153,168,2655,-2487
an8.82,0.37648685849769326,166,108,2150,-2042
an8.83,0.17302158848770954,149,238,2666,-2428
an8.84,4.376269049366499e-05,89,41,3796,-3755
an8.85,4.376269049366499e-05,75,67,3698,-3631
an8.86,0.22472840129283966,588,45,2720,-2675
an8.87,4.376269051586945e-05,94,49,3647,-3598
an8.88,4.376269051586945e-05,97,47,3649,-3602
an8.89,4.376269051586945e-05,97,59,3166,-3107
an8.9,0.34893761559326997,286,28,2197,-2169
an8.90,4.376269051586945e-05,48,13,3341,-3328
an8.91-117,4.376269051586945e-05,40,9,4261,-4252
an9.1,0.5697704304489237,299,345,1707,-1362
an9.10,4.376269051586945e-05,47,83,3375,-3292
an9.11,0.3675889014788103,727,70,2063,-1993
an9.113,4.376269049366499e-05,62,154,3652,-3498
an9.12,0.4058856001934563,563,173,2044,-1871
an9.13,0.15092627075532494,553,226,2846,-2620
an9.14,0.060149142199406036,175,34,3345,-3311
an9.15,4.376269049366499e-05,64,19,3743,-3724
an9.16,4.376269049366499e-05,36,111,3273,-3162
an9.17,4.376269051586945e-05,109,11,4010,-3999
an9.18,0.14556668168699272,154,70,2820,-2750
an9.19,0.2530672652373722,247,38,2570,-2532
an9.2,0.42891573424059803,117,126,2038,-1912
an9.20,0.445830289091087,563,160,1972,-1812
an9.21,4.376269049366499e-05,93,53,3775,-3722
an9.22,0.40716137376100026,514,110,2086,-1976
an9.23,4.376269053807391e-05,52,93,3193,-3100
an9.24,0.21391263172245711,121,164,2690,-2526
an9.25,4.376269051586945e-05,116,113,3360,-3247
an9.26,0.13847519610772352,489,307,2661,-2354
an9.27,0.46904833821823644,262,206,1919,-1713
an9.28,0.28827764977366055,181,145,2363,-2218
an9.29,4.376269049366499e-05,59,13,4153,-4140
an9.3,0.5917220333452766,604,64,1583,-1519
an9.30,4.376269051586945e-05,74,14,3988,-3974
an9.31,0.11673827614875343,72,110,3100,-2990
an9.32,4.376269051586945e-05,22,163,2963,-2800
an9.33,0.13155232520709603,686,62,2856,-2794
an9.34,0.3637863124116958,569,273,2168,-1895
an9.35,0.461362041898461,803,221,1884,-1663
an9.36,0.4515017968650836,876,225,1889,-1664
an9.37,0.5634596471717268,261,343,1754,-1411
an9.38,0.565382047323526,517,213,1493,-1280
an9.39,0.18205860635436277,404,130,2762,-2632
an9.4,0.4170558054235274,771,185,2037,-1852
an9.40,0.29575295241974775,439,147,2337,-2190
an9.41,0.39650295232360744,1981,212,2092,-1880
an9.42,0.2525754503928779,373,224,2474,-2250
an9.43,0.3122626732267486,144,318,2278,-1960
an9.44,0.20262034985012445,61,280,2536,-2256
an9.45,0.3148497920246074,81,253,2311,-2058
an9.46,0.20759008678190582,58,332,2497,-2165
an9.47,0.19191459398941735,58,259,2584,-2325
an9.48,4.376269051586945e-05,7,242,3580,-3338
an9.49,4.376269049366499e-05,5,1,4368,-4367
an9.5,0.534126981479166,325,178,1865,-1687
an9.50,4.376269049366499e-05,7,259,3375,-3116
an9.51,0.37203593988444084,64,406,2149,-1743
an9.52,0.23867249081919173,53,302,2460,-2158
an9.53,4.376269049366499e-05,5,90,3706,-3616
an9.54,4.376269049366499e-05,5,179,3620,-3441
an9.55,4.376269051586945e-05,5,63,3723,-3660
an9.56,4.376269051586945e-05,5,137,3668,-3531
an9.57,4.376269049366499e-05,5,90,3706,-3616
an9.58,4.376269049366499e-05,5,156,3660,-3504
an9.59,4.376269051586945e-05,5,53,3570,-3517
an9.6,0.1802089459210121,558,149,2542,-2393
an9.60,4.376269049366499e-05,5,260,3580,-3320
an9.61,0.1802731607407848,53,252,2616,-2364
an9.62,4.376269051586945e-05,65,52,3388,-3336
an9.63,0.32523656031504533,62,295,2241,-1946
an9.64,0.2201871710659109,61,256,2616,-2360
an9.65,4.376269051586945e-05,49,243,3150,-2907
an9.66,4.376269051586945e-05,25,146,3234,-3088
an9.67,4.376269051586945e-05,28,202,3244,-3042
an9.68,4.376269051586945e-05,26,231,2999,-2768
an9.69,4.376269051586945e-05,26,126,3450,-3324
an9.7,0.2865812633717324,209,73,2462,-2389
an9.70,4.376269051586945e-05,28,196,3030,-2834
an9.71,0.061563642291218024,104,24,3034,-3010
an9.72,0.41785799951190583,192,198,2057,-1859
an9.73,0.08974698358807931,92,201,2759,-2558
an9.74-81,4.376269049366499e-05,5,184,3421,-3237
an9.8,0.2978027352575019,195,66,2418,-2352
an9.82,0.1130935156917312,83,281,2726,-2445
an9.83,0.3581125247613448,47,348,2180,-1832
an9.84-91,4.376269049366499e-05,5,120,3637,-3517
an9.9,4.376269049366499e-05,28,98,3623,-3525
an9.92,0.2822519279104263,62,388,2278,-1890
an9.93,4.376269049366499e-05,28,150,3347,-3197
an9.94,0.05026103766867518,27,259,2662,-2403
an9.95-112,4.376269049366499e-05,42,190,3459,-3269
an10.1,0.14834076803083018,151,112,2875,-2763
an10.10,0.17820112429123292,287,104,2750,-2646
an10.100,4.376269051586945e-05,63,57,3152,-3095
an10.101,0.04288478991620881,59,258,3086,-2828
an10.102,0.18867159396471767,78,334,2600,-2266
an10.103,4.376269049366499e-05,103,29,3780,-3751
an10.105,4.376269051586945e-05,80,36,3582,-3546
an10.106,0.25422317491041735,250,147,2470,-2323
an10.107,0.3980098978261237,260,204,2083,-1879
an10.108,0.3844365823373552,218,124,2132,-2008
an10.109,0.3594382690779385,203,136,2182,-2046
an10.11,0.4922838444540112,174,208,1871,-1663
an10.110,0.2145655292879134,108,105,2519,-2414
an10.111,0.1819538162400658,76,214,2619,-2405
an10.112,4.376269049366499e-05,42,34,3364,-3330
an10.113,4.376269051586945e-05,96,127,3158,-3031
an10.114,0.19350293136821684,304,193,2486,-2293
an10.115,0.41094770680694115,798,290,2012,-1722
an10.116,0.5139019403647138,311,166,1705,-1539
an10.117,0.2012573433962883,153,19,3033,-3014
an10.118,0.22528786748614582,99,53,2569,-2516
an10.119,0.1848662811334778,357,93,2750,-2657
an10.12,0.22142672693459264,112,120,2586,-2466
an10.120,0.11645826674573367,78,98,2748,-2650
an10.121,4.376269049366499e-05,47,69,3282,-3213
an10.122,4.376269051586945e-05,39,204,2784,-2580
an10.123,4.376269049366499e-05,27,78,3276,-3198
an10.124,4.376269051586945e-05,22,96,3169,-3073
an10.125,4.376269051586945e-05,22,93,3198,-3105
an10.126,4.376269051586945e-05,30,111,2987,-2876
an10.127,4.376269051586945e-05,34,119,3282,-3163
an10.128,4.376269051586945e-05,26,143,3171,-3028
an10.129,4.376269051586945e-05,28,124,2999,-2875
an10.13,4.376269049366499e-05,33,91,3778,-3687
an10.130,4.376269051586945e-05,34,144,2963,-2819
an10.131,4.376269051586945e-05,38,159,3256,-3097
an10.132,4.376269049366499e-05,19,61,3627,-3566
an10.133,4.376269051586945e-05,19,60,3528,-3468
an10.134,0.028271519229283726,52,168,3067,-2899
an10.135,4.376269049366499e-05,38,229,3365,-3136
an10.136,4.376269049366499e-05,32,181,3386,-3205
an10.137,4.376269049366499e-05,34,165,3498,-3333
an10.138,4.376269051586945e-05,34,191,3382,-3191
an10.139,4.376269051586945e-05,39,191,3295,-3104
an10.14,0.2985114563862412,673,70,2366,-2296
an10.140,4.376269051586945e-05,39,206,3280,-3074
an10.141,4.376269049366499e-05,39,173,3330,-3157
an10.142,4.376269051586945e-05,40,173,3330,-3157
an10.143,4.376269049366499e-05,39,173,3330,-3157
an10.144,4.376269051586945e-05,39,197,3093,-2896
an10.145,4.376269049366499e-05,40,216,3373,-3157
an10.146,4.376269049366499e-05,35,122,3470,-3348
an10.147,4.376269049366499e-05,35,140,3428,-3288
an10.148,4.376269049366499e-05,34,182,3407,-3225
an10.149,4.376269051586945e-05,42,132,3408,-3276
an10.15,0.17584879678260723,242,194,2516,-2322
an10.150,4.376269051586945e-05,42,129,3416,-3287
an10.151,4.376269049366499e-05,42,189,3353,-3164
an10.152,4.376269051586945e-05,42,124,3371,-3247
an10.153,4.376269049366499e-05,42,123,3420,-3297
an10.154,4.376269051586945e-05,44,134,3374,-3240
an10.155,4.376269049366499e-05,71,311,3589,-3278
an10.156-166,4.376269049366499e-05,125,113,3499,-3386
an10.16,4.376269049366499e-05,35,62,3422,-3360
an10.167,0.19950290626495892,364,93,2680,-2587
an10.168,0.12731529233691585,144,42,3013,-2971
an10.169,0.20599294722181138,165,26,2852,-2826
an10.17,0.5732012439920942,309,222,1762,-1540
an10.170,0.10617440077349549,147,26,3517,-3491
an10.171,4.376269049366499e-05,107,116,3102,-2986
an10.172,0.5172512155131814,962,266,1826,-1560
an10.173,0.1588972835984359,170,136,2705,-2569
an10.174,4.376269049366499e-05,66,14,3756,-3742
an10.175,4.376269049366499e-05,83,56,3943,-3887
an10.176,0.5131071462234127,1008,59,1705,-1646
an10.177,0.44555615671912907,787,504,2007,-1503
an10.178,0.04893866854702722,61,156,2989,-2833
an10.179,4.376269049366499e-05,39,229,3322,-3093
an10.18,0.31909397137730444,567,62,2258,-2196
an10.180,4.376269049366499e-05,32,179,3350,-3171
an10.181,4.376269051586945e-05,34,163,3451,-3288
an10.182,4.376269049366499e-05,34,188,3341,-3153
an10.183,4.376269051586945e-05,40,189,3252,-3063
an10.184,4.376269051586945e-05,40,204,3240,-3036
an10.185,4.376269051586945e-05,39,172,3285,-3113
an10.186,4.376269051586945e-05,39,172,3285,-3113
an10.187,4.376269051586945e-05,40,172,3285,-3113
an10.188,4.376269049366499e-05,39,198,3048,-2850
an10.189,4.376269051586945e-05,39,219,3493,-3274
an10.19,0.1552156102703428,40,48,2655,-2607
an10.190,4.376269049366499e-05,39,200,3517,-3317
an10.191,4.376269049366499e-05,34,143,3558,-3415
an10.192,4.376269049366499e-05,36,182,3372,-3190
an10.193,4.376269051586945e-05,42,132,3368,-3236
an10.194,4.376269049366499e-05,40,170,3298,-3128
an10.195,4.376269049366499e-05,42,186,3306,-3120
an10.196,4.376269049366499e-05,42,127,3333,-3206
an10.197,4.376269051586945e-05,39,136,3333,-3197
an10.198,4.376269049366499e-05,42,135,3353,-3218
an10.199-210,4.376269051586945e-05,205,312,3337,-3025
an10.2,0.24110920375688405,183,46,2760,-2714
an10.20,0.9428893495230684,447,173,1217,-1044
an10.21,0.4192560490585473,559,216,2023,-1807
an10.211,0.582570076223865,511,164,1633,-1469
an10.212,0.15458013431917106,161,270,2623,-2353
an10.213,4.376269051586945e-05,116,277,3506,-3229
an10.214,4.376269049366499e-05,60,119,3735,-3616
an10.215,4.376269049366499e-05,108,127,3625,-3498
an10.216,0.45874902033726794,493,115,1941,-1826
an10.217,0.3962483897774316,817,222,2028,-1806
an10.218,0.11353656298132009,267,15,3269,-3254
an10.219,0.44922323760265837,342,128,1907,-1779
an10.22,0.3879925751438362,370,235,2103,-1868
an10.220,0.24966168371942654,293,313,2494,-2181
an10.221,4.376269049366499e-05,86,276,3506,-3230
an10.222,4.376269049366499e-05,197,124,3661,-3537
an10.223,4.376269051586945e-05,288,118,3604,-3486
an10.224,4.376269051586945e-05,380,128,3481,-3353
an10.225-228,4.376269049366499e-05,39,160,3807,-3647
an10.229,4.376269049366499e-05,62,450,3321,-2871
an10.23,0.39933748638045774,494,39,2079,-2040
an10.233,4.376269051586945e-05,46,232,3723,-3491
an10.237,4.376269049366499e-05,28,167,3168,-3001
an10.24,0.05053554117231407,853,43,3303,-3260
an10.25,4.376269051586945e-05,50,9,3893,-3884
an10.26,0.23678664746797917,196,56,2389,-2333
an10.27,0.5417543258001034,1052,135,1699,-1564
an10.28,0.4729584562979783,666,145,1900,-1755
an10.29,0.5497963401235983,848,127,1696,-1569
an10.3,0.076128461439251,173,139,2709,-2570
an10.30,0.5421857522696749,689,131,1656,-1525
an10.31,0.1852496518372826,74,50,2580,-2530
an10.32,0.11401078456703129,57,8,3065,-3057
an10.33,0.4417710490827842,105,169,1889,-1720
an10.34,0.22212565753239044,113,63,2755,-2692
an10.35,4.376269051586945e-05,92,50,3734,-3684
an10.36,4.376269049366499e-05,94,44,3776,-3732
an10.37,4.376269053807391e-05,77,15,3934,-3919
an10.38,4.376269053807391e-05,81,14,3934,-3920
an10.39,0.1604459837573291,100,71,2712,-2641
an10.4,0.115807889761399,104,167,2747,-2580
an10.40,0.08499488430817603,127,15,3389,-3374
an10.41,4.376269051586945e-05,98,20,2998,-2978
an10.42,4.376269051586945e-05,64,16,3937,-3921
an10.43,4.376269049366499e-05,56,24,4029,-4005
an10.44,0.689321754362493,375,131,1539,-1408
an10.45,0.18644701798751218,314,37,2982,-2945
an10.46,0.5057321951529525,535,33,1660,-1627
an10.47,0.12474164098275065,231,37,3109,-3072
an10.48,0.05846692972391043,119,28,3692,-3664
an10.49,4.376269049366499e-05,22,47,3415,-3368
an10.5,0.17491040115338308,182,154,2506,-2352
an10.50,0.5463202560493929,473,160,1749,-1589
an10.51,0.301233679515156,347,41,2495,-2454
an10.52,0.4095799014870005,297,109,2053,-1944
an10.53,0.30514776434473756,486,52,2412,-2360
an10.54,0.298016925661293,662,125,2321,-2196
an10.55,0.752135539755483,564,354,1343,-989
an10.56,4.376269049366499e-05,37,106,3161,-3055
an10.57,4.376269051586945e-05,35,118,2966,-2848
an10.58,0.1946464040968099,166,238,2633,-2395
an10.59,0.0887790062300331,139,147,2895,-2748
an10.6,0.09968595047966655,237,89,3115,-3026
an10.60,0.6283116154203849,651,183,1598,-1415
an10.61,0.32322509316820014,489,48,2275,-2227
an10.62,0.27961735697377144,454,49,2387,-2338
an10.63,0.3466241546152604,69,238,2207,-1969
an10.64,0.28159482552851944,67,235,2378,-2143
an10.65,0.2587568685627595,106,225,2375,-2150
an10.66,0.20393573027979173,119,169,2606,-2437
an10.67,0.16284035228093519,568,238,2746,-2508
an10.68,0.2592570794920812,497,159,2400,-2241
an10.69,0.30871803315533075,185,43,2336,-2293
an10.7,0.15256562571319687,226,176,2671,-2495
an10.70,0.22275120909525103,208,116,2609,-2493
an10.71,0.3219080420011844,264,66,2284,-2218
an10.72,0.2586545446883637,262,10,2536,-2526
an10.73,0.06767942451062492,187,47,3163,-3116
an10.74,0.01609211388164944,82,21,3605,-3584
an10.75,0.5113641729215912,1008,274,1776,-1502
an10.76,0.0464229816029782,852,29,3562,-3533
an10.77,4.376269049366499e-05,68,76,3866,-3790
an10.78,4.376269049366499e-05,45,13,3883,-3870
an10.79,4.376269049366499e-05,61,10,4095,-4085
an10.8,0.21134263866815495,236,113,2609,-2496
an10.80,4.376269053807391e-05,89,9,3647,-3638
an10.81,0.19054952195263208,135,20,2799,-2779
an10.82,4.376269051586945e-05,319,48,3762,-3714
an10.83,0.4477779883237387,220,75,2044,-1969
an10.84,0.4117300575039895,278,141,2063,-1922
an10.85,0.25865758925620597,661,82,2486,-2404
an10.86,0.4536369547008201,415,146,1943,-1797
an10.87,0.24585373236587493,810,80,2587,-2507
an10.88,0.03461115874616727,75,62,2748,-2686
an10.89,0.38018041315055484,608,56,2125,-2069
an10.9,0.288465315745734,218,103,2389,-2286
an10.90,0.41514508191839994,307,137,2052,-1915
an10.91,0.0670107057646252,1072,53,3709,-3656
an10.92,0.7396425325590927,345,267,1369,-1102
an10.93,0.45869703044434385,710,257,2005,-1748
an10.94,0.29370457932456073,571,145,2351,-2206
an10.95,0.5460736442149505,495,281,1719,-1438
an10.96,0.2291196919677274,471,441,2475,-2034
an10.97,0.8711255014052677,362,295,1337,-1042
an10.98,0.24890923491152073,96,153,2378,-2225
an10.99,0.6937374787163941,1152,160,1200,-1040
an11.1,0.13616576336650255,164,114,2738,-2624
an11.10,0.2262848197682743,191,124,2652,-2528
an11.11,0.5116097578454992,731,179,1822,-1643
an11.12,0.3996849976424244,373,87,2068,-1981
an11.13,0.5586651712247814,417,32,1613,-1581
an11.14,0.5862886909081988,773,95,1434,-1339
an11.15,4.376269049366499e-05,64,15,3505,-3490
an11.16,0.4674352608584398,814,241,1951,-1710
an11.17,0.6173430107885514,1071,120,1494,-1374
an11.18,0.19767093310176787,224,85,2567,-2482
an11.19,0.35818226844852585,206,76,2180,-2104
an11.2,0.22023722444599603,185,45,2825,-2780
an11.20,0.2387177003583707,168,106,2398,-2292
an11.21,0.29171083193657577,258,106,2401,-2295
an11.22-29,0.05125216479520134,116,63,3642,-3579
an11.3,0.07635795708258453,184,143,2703,-2560
an11.30-501,4.376269049366499e-05,11,13,4288,-4275
an11.4,0.21501625499436017,205,185,2454,-2269
an11.5,0.18969613404775654,194,156,2511,-2355
an11.502,0.11868744906564643,34,125,3197,-3072
an11.6,4.376269049366499e-05,161,62,3088,-3026
an11.7,0.2910158656824091,526,108,2324,-2216
an11.8,0.1170690178468714,312,59,3143,-3084
an11.9,0.39270229146668445,554,89,2055,-1966
an11.982,4.376269049366499e-05,29,230,3114,-2884
